Ww, Ww, Ww, Mm, Mm, Mm, Mm, Mm, Mm, Mm, Mm, Mm, Mm, Mm, Mm, Mm, Mm, Mm, Mm, Mm, Mm, Mm, Mm, Mm, Gs^Fms, Gs^Fms, Gs^Fms, Rp, Gs^Fds, Gll^Fp, Mm, Mm
Ww^Es, Ww, Ww, Mm, Mm, Mm, Mm, Mm, Mm, Mm, Mm, Mm, Mm, Mm, Mm, Mm, Mm, Mm, Mm, Mm, Mm, Mm, Mm, Mm, Gs^Fms, Gs^Fms, Gs^Fms, Rp, Gg^Fet, Gs^Fds, Mm, Mm
Mm, Mm, Mm, Mm, Mm, Mm, Mm, Mm, Mm, Mm, Mm, Mm, Mm, Mm, Mm, Mm, Mm, Mm, Mm, Mm, Mm, Mm, Mm, Hh^Fp, Gll^Fp, Gs^Fms, Rp, Rp, Gg^Efm, Gg^Efm, Mm, Mm
Mm, Mm, Mm, Mm, Mm, Mm, Hhd^Vo, Mm, Mm, Mm, Mm, Mm, Mm, Mm, Mm, Mm, Mm, Mm, Re, Mm, Mm, Mm, Mm, Hh, Hh, Gs^Fms, Rp, Gs^Fms, Gs^Fp, Mm, Mm, Mm
Mm, Mm, Mm, Mm, Mm, Mm, Mm, Mm, Mm, Mm, Mm, Hhd^Vo, Mm, Mm, Mm, Re^Vo, Re^Es, Re^Es, Ce, Ce, 2 Ke, Gs, Gs, Gg, Gg, Gg, Re, Gs^Fp, Gs^Vo, Mm, Mm, Mm
Mm, Mm, Mm, Mm, Mm, Mm, Mm, Mm, Hhd^Vo, Mm, Mm, Mm, Mm, Mm, Mm, Re^Dr, Gd^Vo, Re, Gd, Ce, Gs, Gs, 1 Ke, Gg, Gs, Re, Gs, Gs, Mm, Mm, Mm, Mm
Mm, Mm, Mm, Mm, Mm, Mm, Mm, Mm, Mm, Mm, Gs^Fms, Gs^Fp, Re^Es, Gs, Gs^Es, Re^Es, Gs^Es, Gs^Es, Gd^Es, Gd, Gd, Ce, Ce, Gs, Re, Re, Gs^Vo, Mm, Mm, Mm, Mm, Mm
Mm, Mm, Mm, Mm, Hhd^Vo, Mm, Mm, Mm, Mm, Ww^Es, Re, Re^Es, Re, Gs, Gs, Gs, Gd, Gd, Gd, Gd, Gd, Ce, Gs, Rr, Gs, Gs, Mm, Mm, Mm, Mm, Mm, Mm
Mm, Mm, Mm, Mm, Mm, Mm, Mm, Mm, Mm, Mm, Mm, Gs^Vo, Gd^Fp, Gd^Fp, Gd^Fms, Gd^Fp, Gd, Ww, Ww, Wwg, Wwg, Wwg, Rr, Rr, Ss, Ss, Mm, Mm, Mm, Mm, Mm, Mm
Mm, Mm, Mm, Mm, Mm, Mm, Hhd^Vo, Mm, Mm, Mm, Mm, Gd^Fp, Gd^Fet, Gll^Fmw, Gd^Fmw, Gs^Em, Gs, Ww, Ww, Wwg^Es, Ww, Wwg, Ww^Bsb|, Ww, Ww, Ww, Ww, Ww^Es, Wwg, Wwg, Wwg, Wwg
Mm, Mm, Mm, Mm, Mm, Mm, Mm, Mm, Mm, Mm, Mm, Gd^Fp, Gd^Fmw, Gd^Fp, Gd^Vo, Gs, Gs, Ww, Ww, Ww, Hh, Hh, Rp, Hh, Ww, Ww, Wwg, Wwg, Wwg, Wwg, Wwg, Wwg
Mm, Mm, Kte, Hhd, Mm, Mm, Mm, Mm, Mm, Mm, Gd^Vo, Gd^Fms, Gd^Fp, Re^Es, Re, Re^Es, Ww, Ww, Ww, Hh, Rr, Rp, Mm, Hh^Vhh, Mm, Mm, Mm, Mm, Mm, Mm, Mm, Mm
Mm, Mm, Cte, Hhd, Hhd, Mm, Mm, Hh, Hh, Gs^Fp, Gs^Fp, Gd^Fms, Re^Es, Re^Es, Ww, Ww, Ww, Re, Rp, Rr, Hh, Mm, Mm, Mm, Mm, Mm, Mm, Mm, Mm, Mm, Mm, Mm
Mm, Mm, Hhd, Mm, Mm, Mm, Mm, Mm, Mm, Hh, Hh, Gs^Fp, Re, Ww, Wwg, Ww, Re, Re^Es, Rp, Hh, Mm, Mm, Mm, Mm, Mm, Mm, Mm, Mm, Mm, Mm, Mm, Mm
Mm, Mm, Mm, Mm, Gd^Fp, Gd^Fmw, Gd^Fp, Gd^Fp, Gd^Vo, Gs, Gs^Em, Ww, Ww, Ww, Wwg, Wwg, Rr, Rp, Hh, Mm, Mm, Mm, Mm, Mm^Vhh, Mm, Mm, Mm, Mm, Mm, Mm, Mm, Mm
Mm, Mm, Mm, Mm, Gg^Fet, Gg^Fms, Gd^Fmw, Ww^Wkf, Ww, Ww, Ww, Ww, Re^Es, Re, Wwg, Wwg^Es, Rr, Hh, Hh, Mm, Mm, Mm, Mm, Mm, Mm, Mm, Mm, Mm, Mm, Mm, Mm, Mm
Mm, Mm, Mm, Mm, Mm, Gd^Fms, Gg^Vo, Ww^Wkf, Ww, Gd^Fms, Gg^Vo, Gd^Fp, Gs^Fmw, Wwg, Mm, Hh, Rr, Mm, Mm, Mm, Mm, Mm, Mm, Mm, Hh^Vhh, Mm, Mm, Mm, Mm, Mm, Mm, Mm
Mm, Mm, Mm, Mm, Hh, Hh, Wwg, Ww, Wwg, Gd^Fmw, Gd^Fms, Wwg^Wkf, Wwg, Wwg, Mm, Cud, Cud, Cud, Cud, Mm, Mm, Mm, Mm, Mm, Mm, Hh, Hh, Mm, Mm, Mm, Mm, Mm
Mm, Mm, Hh, Hh, Hh, Wwg, Wwg, Wwg, Re^Vo, Gd^Fmw, Ww^Wkf, Ww, Mm, Mm, Mm, Cud, 5 Kud, Cud, Cud, Mm, Mm, Mm, Mm, Mm, Mm, Mm, Hh, Hh^Fp, Mm, Mm, Mm, Mm
Mm, Mm, Hh, Hh, Wwg, Wwg, Wwg, Re^Em, Gs^Fp, Gd^Fms, Ww, Ww, Mm, Mm, Mm, Cud, Cud, Cud, Cud, Mm, Mm^Vhh, Mm, Mm, Mm^Vhh, Mm, Hh, Hh, Hh, Mm, Mm, Mm, Mm
Mm, Mm, Hh, Hh, Wwg, Ww, Ww, Gs^Fms, Gs^Fp, Ww, Ww, Mm, Mm, Mm, Hh^Fp, Hh^Fp, Hh^Fp, Rp, Hh^Fp, Hh^Fmw, Hh^Fmw, Mm, Mm, Mm, Hh^Fp, Hh, Mm, Mm, Mm, Mm, Mm, Mm
Hh^Fp, Gll^Fp, Gs^Fms, Ww, Ww, Ww^Es, Wwg, Ww, Ww, Ww, Hh^Fp, Hh^Fmw, Hh^Fp, Hh^Fmw, Hh^Fp, Hh^Fmw, Hh^Fp, Rp, Rr, Hh^Fp, Hh^Fp, Hh^Fp, Hh^Fp, Mm, Hh, Hh, Mm, Mm, Mm, Mm, Mm, Mm
Hh^Fp, Gll^Fp, Gd^Vo, Ww, Ww, Ww, Wwg, Gg, Gll^Fp, Hh^Fp, Hh^Fp, Mm, Mm, Mm, Mm, Mm, Mm, Mm, Mm, Rr, Rp, Mm, Mm, Hh^Vl, Hh, Mm, Mm, Mm, Mm, Mm, Mm, Mm
Hh^Fp, Gd^Fp, Gd^Fp, Gd, Gs^Es, Ww, Wwg, Wwg, Re, Hh, Gll^Fp, Hh, Gll^Fp, Hh, Hh, Mm, Mm, Mm, Mm, Mm, Mm, Rp, Mm, Mm, Hh, Hh, Hh, Mm, Mm, Mm, Mm, Mm
Hh^Fp, Gs^Fms, Gs^Fms, Gll^Fp, Gs, Gs^Es, Gs, Wwg, Wwg, Wwg^Wkf, Re, Re, Gll^Fp, Gll^Fmw, Gll^Fp, Hh, Hh, Hh, Mm, Mm, Mm, Rp, Rp, Gs^Fp, Mm, Mm, Mm, Mm, Mm, Mm, Mm, Mm
Mm, Mm, Mm, Mm, Hhd^Vo, Mm, Hh, Wwg, Wwg, Wwg, Wwg, Ww, Ww, Gs^Em, Re, Re, Hh^Vhh, Rp^Es, Hh, Hh, Hh, Mm, Mm, Rr, Rr, Mm, Mm^Vhh, Mm, Mm, Mm, Mm, Mm
Mm, Mm, Mm, Mm, Hhd, Mm, Mm, Hh, Hh, Gll^Fp, Wwg^Wkf, Ww^Es, Ww, Ww, Ww, Rp, Rp, Hh, Hh, Mm, Mm, Mm, Mm, Mm, Rr, Mm, Mm, Mm, Mm, Mm, Mm, Mm
Mm, Mm, Mm, Mm, Hhd, Mm, Mm, Mm, Mm, Gll^Fp, Gll^Fp, Gll^Fp, Gs, Gs, Ww, Wwg, Wwg, Ww, Ww, Mm, Mm, Mm, Mm, Mm, Rr, Mm, Mm, Mm, Mm, Mm, Mm, Mm
Mm, Mm, Mm, Hhd, Mm, Mm, Mm, Mm, Mm, Mm, Mm, Mm, Hh, Gs, Wwf, Ww, Wwg, Wwr, Ww, Mm, Mm, Mm, Mm, Mm, Mm, Rp, Hh, Mm, Mm, Mm, Mm, Mm
Mm, Mm, Hhd, Hhd, Mm, Mm, Mm, Mm, Mm, Mm, Mm, Hh, Hh, Gs^Fp, Re, Wwf, Wwg, Wwg, Ww, Mm, Mm, Mm, Mm, Mm, Mm, Rp, Rr, Mm, Hh^Fp, Mm, Mm, Mm
Mm, Mm, Hhd, Mm, Mm, Mm, Mm, Mm, Mm, Mm, Mm, Hh, Hhd, Gd^Fp, Re^Es, Gd, Wwf, Ww, Ww, Ww, Mm, Mm, Mm, Mm^Vhh, Mm, Mm, Mm, Rr, Hh^Fp, Mm^Vhh, Mm, Mm
Cte, Cte, Cte^Es, Cte, Mm, Mm, Mm, Mm, Mm, Mm, Mm, Hhd, Hhd, Gd^Fp, Re, Gd^Vo, Gd^Fp, Hh, Ww, Ww, Ww^Es, Wwg, Mm, Mm, Mm, Mm, Mm, Rr, Mm, Mm, Mm, Mm
Cte, 3 Kte, Cte^Es, Mm, Mm, Mm, Mm, Hhd^Fp, Hhd^Fp, Hhd^Fp, Hhd^Fp, Hhd^Fp, Gd^Fp, Gd^Es, Re^Es, Gd^Fp, Hh, Hh, Mm, Ww, Ww, Wwg, Mm, Mm, Mm, Mm, Rr, Rr, Mm, Mm, Mm, Mm
Cte, Cte^Es, Cte, Cte^Es, Mm, Mm, Mm, Mm, Mm, Mm, Mm, Mm, Mm, Gd^Es, Re, Gg, Hh, Hh, Hh, Mm, Ww, Wwg, Wwg, Mm, Mm, Rr, Mm, Mm, Mm, Ww, Mm, Mm
Mm, Mm, Mm, Mm, Mm, Mm, Mm, Mm, Mm, Mm, Mm, Mm, Mm, Gd^Vo, Re, Gg^Es, Gg^Es, Hh, Hh, Mm, Hh, Wwg, Ww, Mm, Hh^Fp, Rp, Gll^Vl, Mm, Ww, Ww, Ww, Ww
Mm, Mm, Hhd, Mm, Mm, Mm, Mm, Mm, Mm, Mm, Mm, Mm, Hhd, Hhd, Hh, Re, Re, Gg, Gg, Hh, Ww, Wwg, Ww, Hh^Fp, Gs^Fms, Rp, Gs^Fms, Mm, Ww, Gs^Fp, Gs^Fp, Gs^Fp
Mm, Mm, Hhd, Mm, Hhd^Vo, Mm, Mm, Mm, Mm, Mm, Mm, Mm, Mm, Mm, Mm, Hh, Hh, Re, Re, Gs^Fp, Ww, Ww, Wwr, Hh^Fp, Hh^Fp, Rp, Hh^Fp, Mm, Ww, Ww^Wkf, Gs^Fms, Gs^Fp
Mm, Mm, Mm, Mm, Mm, Mm, Mm, Mm, Mm, Mm, Wwr, Mm, Mm, Mm, Mm, Mm, Hh, Gs^Fp, Gs^Fp, Re, Wwf, Ww, Ww, Ww, Ww, Ww^Bsb|, Ww, Ww, Gs^Fms, Gs^Fms, Hh, Hh
Hhd, Hhd, Mm, Mm, Mm, Mm, Mm, Mm, Ww, Mm, Ww, Ww, Ww, Ww, Ww, Mm, Ww, Hh, Gs^Fp, Ds, Ww, Wwf, Wwf, Gs^Es, Re, Re, Re, Gs^Fms, Gg^Fet, Gs^Fds, Hh, Hh
Mm, Mm, Mm, Mm, Mm, Mm, Mm, Ww, Wo, Ww, Mm, Mm, Wwr, Hh, Hh, Ww, Gg^Em, Ww, Ww, Ww, Wwg, Ww, Ww, Re, Gs^Fms, Gll^Fp, Gs^Fms, Re, Re, Gs^Fms, Gs^Fp, Gs^Fp
Mm, Mm, Mm, Mm, Mm, Mm, Ww, Ww, Wo, Ww, Mm, Mm, Mm, Gll^Fp, Gll^Fp, Gll^Fp, Gll^Fp, Gs^Fms, Gs^Fds, Ww^Wkf, Wwg, Ww, Gg, Gs^Fms, Gs^Fms, Gs^Fds, Gs^Fms, Gs^Fms, Mm, Re, Re, Gg
Mm, Mm, Mm, Mm, Mm, Ww, Wo, Wo, Wo, Mm, Mm, Mm, Mm, Gll^Fp, Gs^Fds, Gs^Fds, Gs^Fms, Gs^Fms, Gs^Fds, Wwg^Wkf, Wwg, Wwg, Gg, Gs^Fms, Gs^Fms, Gs^Fds, Hh^Fms, Hh^Fms, Mm, Mm, Gg, Re
