Gs^Fms, Gs^Fds, Gs^Fds, Gs^Fds, Gs^Fds, Gs^Fds, Gs^Fds, Gs^Fds, Gs, Ww, Gs^Fds, Gs^Fds, Gs^Fds, Gs^Fds, Hh, Hh, Hh, Hh, Hh, Hh, Hh, Hh, Rr, Rr, Hh, Gs^Fds, Hh, Gs^Fds, Gs^Fds, Gs^Fds, Gs^Fms, Gs^Fds
Gs^Fds, Gs^Fds, Gs^Fds, Gs^Fds, Gs^Fds, Gs^Fds, Gs^Fds, Gs^Fds, Gs^Fds, Ww, Ww, Gs^Fds, Gs^Fds, Gs^Fds, Gs^Fds, Hh, Hh^Fms, Hh, Gs^Fds, Hh, Rr, Rr, Gs^Fds, Gs, Gs^Fds, Hh, Hh^Fms, Gs^Fds, Ce, Gs^Fds, Gs^Fds, Gs^Fds
Gs^Fds, Gs^Fds, Ce, Ce, Ce, Gs, Gs^Fds, Gs^Fds, Gs^Fds, Gs^Fds, Ww, Gs^Fds, Gs, Gs^Fds, Gs^Fds, Gg^Ve, Gs^Fds, Gs^Fds, Hh, Gs^Fds, Rr, Gs^Fds, Gs^Fds, Gs^Fds, Gs^Fds, Hh, Ce, Ce, 4 Ke, Ce, Gs^Fds, Gs^Fds
Gs^Fds, Gs^Fms, Ce, 5 Ke, Ce, Gs^Fds, Gs^Fms, Gs^Fds, Gs^Fds, Gs^Fds, Gs^Fds, Ww, Ww, Gs, Gs^Fds, Gs^Fds, Gs^Fds, Hh, Rr, Rr, Gs^Fds, Gs^Fds, Gs^Fds, Gs^Fds, Gs^Fds, Gs^Fds, Gs^Fds, Ce, Ce, Ce, Gs^Fds, Gs^Fds
Gs^Fds, Gs^Fds, Gs^Fds, Ce, Gs, Ce, Gs^Fds, Gs^Fds, Gg^Fet, Gs^Fds, Gs^Fds, Gs^Fds, Gs^Fds, Ww, Gs^Fds, Gs^Fds, Rr, Rr, Gs^Fds, Gs^Fds, Gs^Fds, Gs^Fds, Gs^Fds, Gs^Fds, Gs^Fds, Ww^Es, Gs^Fdw, Gs^Fds, Ce, Gs^Fds, Gs^Fds, Gs^Fds
Gs^Fds, Gs^Fds, Gs^Fds, Ce, Gs^Fms, Gs^Fds, Gs^Fds, Gs^Fds, Gs^Fds, Gs^Fms, Gs^Fds, Gs^Fmw, Gs^Fds, Ww, Ww, Gs^Fms, Rr, Gs^Fds, Gs^Fds, Gs^Fds, Ww, Gs^Fds, Gs^Fds, Gs^Fds, Gs^Fds, Ww, Gs^Fds, Gs^Fds, Gs^Fds, Gs^Fds, Gs^Fds, Gs^Fds
Gs^Fds, Gs^Fds, Gs^Fds, Gs^Fds, Gs^Fds, Gs^Fds, Gs^Fds, Gs^Fds, Gs^Fds, Gs^Fms, Gs^Fds, Gs^Fds, Gs, Gs^Fds, Rr, Ww^Bsb/, Ww, Gs^Fds, Gs^Fds, Ww, Gs^Fds, Ww, Ww, Gs^Fds, Gs^Fds, Gs^Fds, Gs^Fds, Gs^Fds, Gs^Fds, Gg^Fet, Gs^Fds, Gs^Fds
Gs^Fds, Gs^Fds, Gs^Fds, Re, Re, Gs^Fds, Gs^Fms, Gs, Gs^Fds, Gs^Fds, Gs^Fds, Gs^Fds, Gs^Fds, Rr, Gs^Fds, Gs^Fds, Gs^Fds, Ww, Ww, Ww, Gs^Fds, Gs^Fds, Ww, Gs^Fds, Gs^Fds, Gs^Fds, Gs^Fds, Gg^Ve, Gs^Fds, Gs^Fds, Ss, Ss
Gs^Fds, Gs^Fmw, Gs^Fds, Gs^Fds, Re, Gs^Fds, Gg^Ve, Gs^Fds, Gs^Fds, Gs^Fds, Gs^Fds, Gs^Fds, Gs^Fds, Rr, Gs^Fds, Gg^Ve, Gs^Fds, Gs^Fds, Gs^Fds, Gs^Fds, Gg^Fet, Gs^Fds, Ww, Gs^Fds, Gs^Fds, Gs^Fds, Gs^Fds, Gs^Fds, Gs^Fds, Ss, Ss, Ss
Gs^Fds, Gs^Fds, Gs^Fds, Gs^Fds, Gs^Fms, Gs^Fds, Gs^Fds, Gs^Fds, Gs^Fds, Gs^Fds, Gs, Gs^Es, Gs^Fds, Rr, Rr, Gs^Fds, Gs^Fds, Gs^Fms, Gs^Fds, Gs^Fds, Gs^Fds, Gs^Fds, Gs^Fds, Ww, Ww, Gs^Fds, Gs^Fds, Gs^Fds, Gs^Fds, Ss, Ss, Ss
Hh, Gs^Fds, Hh, Gg, Gs^Fds, Gs^Fds, Gs, Gg, Gs^Fms, Gs^Fds, Gs^Fds, Gs^Fms, Gs^Fds, Gs^Fds, Gs^Fds, Rr, Gs^Fds, Gs^Fds, Gs^Fds, Gs^Em, Gs^Fds, Gs^Fms, Gs^Fds, Gs^Fds, Ww, Gs^Fds, Gs^Fds, Gs^Em, Gg^Ve, Gs^Fds, Gs^Fds, Ss
Hh, Hh, Gs^Fds, Gg, Gg, Gs^Fds, Re^Gvs, Gs, Gg^Ve, Gs^Fds, Gs^Fds, Gs^Fds, Gs^Fds, Gs^Fds, Gd^Fet, Rr, Gd^Fet, Gs^Fds, Gs^Fms, Gs^Fds, Gs^Fds, Gs^Fds, Ww, Ww, Gs^Fds, Gs^Fds, Gs^Fds, Gs^Fds, Gs^Fmw, Gs^Fds, Gs^Fds, Gs^Fms
Hh, Hh^Fms, Gs^Fds, Gs^Fds, Gs^Fds, Re^Gvs, Re^Gvs, Gs^Fds, Gs^Fds, Gs^Fds, Gs^Fds, Gs^Fds, Gd^Fdf, Gd^Fdf, Gd^Fdf, Rr^Efm, Gd^Fdf, Gd^Fdf, Gd^Fdf, Gs^Fms, Gs^Fds, Gs^Fds, Gs^Fds, Ww, Gs^Fds, Gs^Fds, Gs^Fds, Gs^Fds, Ss, Gs^Fds, Gs^Fds, Gs^Fms
Hh, Hh, Hh^Fms, Gg^Fet, Gs^Fds, Re^Gvs, Re^Gvs, Re^Gvs, Gs^Fds, Gs^Fms, Gs^Fds, Gd^Fet, Gd^Fdf, Gd^Ve, Rp, Rp^Efm, Rp, Gd^Ve, Gd^Fdf, Gd^Fet, Gs^Fds, Gs^Fds, Gs^Fds, Ww, Ww, Gs^Fds, Ww, Gs^Fds, Gs^Fds, Ss, Gs^Fds, Gs^Fds
Gs^Fds, Hh, Gs^Fds, Gs^Fds, Gg^Ve, Gs^Fds, Re^Gvs, Re^Gvs, Gs, Gs^Fds, Gs^Fms, Gd^Fmf, Gll^Fdf, Rp, Cv^Efm, Cv^Efm, Cv^Efm, Rp^Efm, Gd^Ve, Gd^Fmf, Gs^Fms, Gs^Fds, Gs^Fms, Gs^Fds, Gs^Fds, Ww, Gs^Fds, Ww, Ww, Gs^Fds, Gs^Fds, Gs^Fds
Gs^Fds, Gs^Fds, Gs^Fds, Gs^Fds, Gg, Re^Gvs, Gs^Fds, Gs^Fds, Gs^Fds, Gs^Fds, Gs^Fds, Gd^Fdf, Gd^Fdf, Gd^Fdf, Cv^Efm, 6 Kv, Cv^Efm, Gd^Fdf, Gd^Fdf, Gd^Fdf, Gs^Fms, Gs^Fds, Gs^Fds, Gs^Fds, Gs^Fds, Gs^Fds, Gs^Fms, Gs^Fds, Ww, Gs^Fds, Gs^Fds, Ss
Gs^Fds, Gs^Fds, Gs^Fds, Gs^Fds, Gs^Fds, Gg, Gs^Fds, Gg^Ve, Gs^Fds, Gs^Fds, Gs^Fds, Gll^Fdf, Gd^Fdf, Rp^Efm, Rp, Cv^Efm, Rp^Efm, Rp, Gd^Fdf, Gll^Fmf, Gs^Fds, Gs^Fds, Ss, Gs^Fds, Gs^Fms, Gg^Fet, Gs^Fds, Gs^Fds, Ww, Gs^Fds, Gs^Fds, Gs^Fds
Gs^Fms, Gs^Fdw, Gs^Fds, Gs^Fms, Gs^Fds, Gs^Fdw, Gs^Fds, Gs^Fds, Gs^Fds, Gs^Fms, Gs^Fds, Gd^Fet, Gd^Fdf, Gd^Ve, Gd^Fdf, Rp^Efm, Gll^Fdf, Gd^Fdf, Gd^Fdf, Gd^Fet, Gs^Fds, Ss, Ss, Gs^Fds, Gs^Fds, Gs^Fds, Gs^Fds, Gs^Fds, Ww, Gs^Fds, Gs^Fds, Gs^Fds
Gs^Fds, Gs^Fds, Gs^Fds, Gs^Fds, Gs^Fds, Gs^Fms, Gs^Fds, Gs^Fds, Gs^Fds, Gs^Efm, Gs^Fds, Gs^Fms, Gs^Fds, Gd^Fdf, Gd^Fet, Rr, Gd^Fet, Gd^Fmf, Gs^Fds, Gs^Fms, Gs^Fds, Ss, Ss, Ss, Ww, Gs^Fds, Ww, Ww, Gs^Fds, Gs^Fds, Gs^Fds, Gs^Fds
Gs^Fds, Gs^Fds, Gs^Fds, Gs^Fds, Gs^Fds, Gs, Gs^Fds, Gs^Fds, Gs^Fds, Gs^Fds, Gs^Fds, Gs^Fds, Gs^Fds, Gs^Fds, Gs^Fds, Rr^Efm, Gs^Fds, Gs^Fms, Gs^Fds, Gs, Gs^Fds, Gs^Fds, Ww, Ww, Gs^Fds, Ww, Ss, Ww, Gs^Fms, Gs^Fds, Gs^Fds, Gs^Fms
Gs^Fds, Gs^Fdw, Gs^Fds, Gg^Ve, Gs, Gs, Wwf, Ww, Ww, Ww, Ww, Ww, Ww, Gs^Fds, Rr, Rr, Ww, Gs^Fds, Ww, Ww, Ww, Gs^Fds, Ww, Re, Re, Ss, Gs^Fds, Gg, Gs^Fds, Gs^Fds, Gs^Fds, Gs^Fds
Gs^Fds, Gs^Fds, Gs^Fds, Gs^Fms, Gs^Fds, Ww, Gs^Fds, Gs^Fds, Gs^Fds, Gs^Fms, Gs^Fds, Gs^Fds, Gs^Fds, Ww, Ww^Bsb|, Ww, Gs^Fds, Ww, Gs^Fds, Gs^Fds, Gs^Fds, Ww, Gs^Fds, Gs^Fds, Gs^Fds, Gs^Fds, Gg, Gg^Ve, Gs^Fds, Gs^Fds, Gs^Fds, Gs^Fds
Gs^Fds, Gs^Fds, Gs^Fds, Gs^Fds, Ww, Ww, Gs^Fds, Gs^Fds, Gg^Ve, Gs^Fds, Gs^Fds, Gs^Fds, Gs^Fds, Gs^Fds, Rr, Gs^Fds, Gs^Fds, Gs^Fds, Gs, Gs^Fds, Gs^Fms, Gs^Fds, Gs^Fds, Gs^Fds, Cvr, Gs^Fds, Gs^Fds, Gs, Gg, Gs^Fds, Gs^Fds, Gs^Fds
Ww, Ww, Ww, Ww, Gs^Fds, Gs^Fds, Gs^Fms, Gs^Fds, Gs^Fds, Gs^Fds, Gs^Fds, Gs^Fds, Rr, Rr, Gs^Fds, Rr, Rr, Rr, Rr, Rr, Rr, Gs^Fds, Rr, Cvr, 3 Kvr, Cvr, Gg, Gs^Fds, Gs^Fds, Gs^Fds, Gs^Fds, Gs^Fds
Gs^Fds, Gs^Fds, Gs^Fds, Gs^Fds, Gs^Fds, Gs^Fds, Gs^Fds, Gs^Fmw, Gs^Fds, Gs^Fds, Gs^Fms, Gs^Fds, Rr, Gs^Fds, Gs^Fds, Gs^Fds, Gs^Fds, Gs^Fds, Gs^Fds, Gs^Fds, Gs^Fds, Rr, Re, Cvr, Cvr, Gg, Gs^Fds, Gs^Fds, Gg^Ve, Gs^Fds, Gs^Fds, Gs^Fmw
Gs^Fds, Gs^Fds, Gs^Fds, Gs^Fds, Gs^Fds, Gs^Fms, Gs^Fds, Gs^Fds, Gs^Fms, Gs^Fds, Rr, Rr, Gs^Fds, Gs^Fds, Gs^Fds, Gs^Fds, Gs^Fms, Hh^Fms, Gs^Fds, Gs^Fds, Gs^Fmw, Re^Gvs, Re^Gvs, Re, Gs^Es, Gg, Gg, Gs^Fds, Gs^Fds, Gs^Fds, Gs^Fms, Gs^Fds
Gs^Fds, Gs^Fds, Gs^Fms, Gg^Fet, Gs^Fds, Gs^Fds, Gs^Fds, Gs^Fms, Gs^Fms, Rr, Gs^Fds, Gs^Fds, Gs, Gs^Fds, Gs^Fds, Gs^Fds, Hh, Hh, Hh, Gs^Fds, Gg, Re^Gvs, Re^Gvs, Gs, Gg^Fet, Gg, Gs^Fds, Gs^Fds, Gs^Fds, Gs^Fds, Gs^Fds, Gs^Fds
Gs^Fds, Gs^Fds, Gs^Fms, Gs^Fds, Gs^Fds, Gs^Fds, Ce, Ce, Ce, Rr, Gs^Fds, Gs^Fds, Gs^Fds, Gs^Fds, Gs^Fds, Hh^Fms, Hh, Hh^Fms, Gs^Fds, Gs^Fds, Gs^Fds, Re^Gvs, Re^Gvs, Re^Gvs, Gg, Gs^Fds, Gs^Fds, Gs^Fms, Gs^Fds, Gs^Fds, Gs^Fds, Gs^Fds
Gs^Fds, Gs, Gs^Fms, Gs^Fdw, Gs^Fds, Gs^Fds, Ce, 1 Ke, 2 Ke, Ce, Gs^Fds, Gs^Fds, Re, Gs^Fds, Re, Gs^Fds, Hh, Hh^Fds, Gs^Fds, Gs^Fds, Gs^Fds, Gs^Fds, Gs^Fds, Re^Gvs, Gs^Fds, Gg^Ve, Gs^Fds, Gg, Gg^Efm, Gg, Gs^Fds, Gs^Fds
Gs^Fds, Gs^Fds, Gs^Fds, Gs^Fds, Gs^Fds, Gs^Fds, Rr, Ce, Ce, Ce, Gs^Fds, Gs^Fds, Gg^Ve, Re, Gs^Fds, Gs^Fds, Hh^Fds, Hh^Fds, Gs^Fds, Gg^Ve, Gs, Gs^Fms, Gs^Fds, Gs^Fms, Gs^Fds, Gs^Fds, Gs^Fds, Gs^Fds, Gg, Gs^Fds, Gs^Fds, Gs^Fds
Gs^Fds, Gs^Fds, Gs^Fds, Gs, Rr, Rr, Gs^Fdw, Gs^Fds, Gs^Fds, Gs^Fds, Gs^Fds, Gs^Fds, Gs^Fds, Gs^Fds, Gs^Fds, Gs^Fds, Gs^Fds, Hh^Fds, Gs^Fds, Gs^Fds, Gg, Gs^Fds, Gs^Fds, Gs^Fds, Gs^Fds, Hh, Hh, Hh, Hh, Gs^Fds, Hh, Hh
Gs^Fds, Gs^Fds, Gs^Fds, Gs^Fds, Rr, Gs^Fds, Gs^Fds, Gs^Fds, Gs^Fds, Gs^Fds, Gs^Fds, Gs^Fds, Gs^Fms, Gs^Fms, Gs^Fds, Gs^Fdw, Gs^Fds, Gs^Fds, Gs^Fds, Gs, Gs, Gs, Hh, Hh, Gs^Fms, Hh, Hh, Hh, Hh, Hh, Hh, Hh
