Gs, Gs, Gs^Fds, Gs^Fds, Gs^Fds, Ss, Ss, Ss, Ss, Ss, Ss, Ss, Ss, Ss, Ss, Ss, Ss, Ss, Ss, Ss, Ss, Ss, Co, Co, Co, Ss, Gll^Fmw, Hh, Hhd, Hhd, Xue, Xue, Xue, Xu, Xue, Xue, Xue
Gs, Gs, Gs, Gs, Re, Gs^Fds, Ss, Ss, Ss, Gll^Fp, Gll^Fp, Ss, Ss^Vhs, Ss, Gll^Fmw, Gll^Fmw, Gll^Fdw, Ss^Vhs, Ss, Ss, Ss, Ss, Co, Co, Co, Ss, Gll^Fp, Gll^Fmw, Gll^Fmw, Hhd, Hhd, Xue, Xue, Xue, Xue, Xue, Hhd
Gs^Fds, Gs, Gs^Fms, Gs^Fms, Re, Ss, Ss, Ss, Ss, Ss, Gll^Fp, Gll^Fp, Rb, Ss, Ss, Gll^Fmw, Gll^Fp, Gll^Fmw, Gll^Fdw, Ss, Ss, Ss, Co, 3 Ko, Co, Ss, Gll^Fmw, Gll^Fp, Gll^Fdw, Hhd, Ss, Hhd, Sm, Uue, Hhd, Hhd, Hhd
Gs^Fds, Gs, Gs, Gs, Re, Re, Re, Ss^Vhs, Ss, Ss, Re, Gll^Fp, Gll^Fp, Rb, Ss, Gll^Fmw, Gll^Fmw, Gll^Fp, Ss, Ss, Ss, Ss, Rb, Rb, Ss, Ss, Gll^Fmw, Gll^Feth, Gll^Fmw, Ss, Ss, Ss, Rp, Rb, Rrd, Rrd, Rrd
Gs, Gs, Gd, Gs^Vht, Gs, Gs^Fms, Re, Re, Gs, Re, Re, Ss, Ss, Rb, Ss, Ss, Gll^Fmw, Gll^Fp, Gll^Fmw, Ss^Vht, Ss, Ss, Rb, Rb, Ss, Ss, Ss, Gll^Fp, Gll^Fdw, Ss, Ss, Ss, Rp, Rb, Rb, Rrd, Rrd
Gs, Gd, Ce, Gs, Ce, Gs, Gs, Gs^Fp, Gd, Gs, Re, Re, Re, Ss, Rb, Ss, Rb, Gll^Fmw, Rb, Rb, Ss, Ss, Gll^Fp, Rb, Rb, Ss, Ss, Gll^Fmw, Ss, Ss, Ss, Ss, Ss, Sm, Rb, Ds, Rrd
Gd, Gs, Ke, Ce, Gs, Gs^Fms, Gs^Fms, Gd, Gs^Vht, Gs^Fp, Gs, Gs, Gs, Gs^Fp, Gll^Fp, Rb, Gll^Fp, Rb, Ss, Ss, Ss, Ss, Gll^Fp, Gll^Fp, Gll^Fmw, Rb, Ss, Ss, Ss, Ss, Rb, Ss, Rb, Rb, Ds, Ds, Ds
Gs, Gs, Gg, Gg, Gs, Gs, Gs, Gs, Gs^Fp, Gs^Fp, Gs, Gs^Fp, Re, Gs^Fp, Gll^Fp, Gll^Fp, Gll^Fp, Rb, Rb, Ss^Vhs, Rb, Gll^Fmw, Rb, Rb, Rb, Rb, Rb, Rb, Rb, Rb, Rb, Rb, Rb, Ds, Ds, Ds^Vd, Rrd
Gs, Gs, 1 Ke, Ce, Ce, Gs, Gs^Fms, Gs^Fms, Gs^Fp, Gs, Gs, Gs^Fp, Re, Gs^Fp, Ss^Vhs, Gll^Fp, Gll^Fp, Rb, Ss, Rb, Ss^Fp, Rb, Ss, Ss^Vhs, Gll^Fmw, Ss, Gll^Fmw, Rb, Ss^Fp, Ss^Fp, Ss^Fp, Sm, Rb, Rb, Rb, Rrd, Rrd
Gs^Fds, Gs^Fds, Gs^Fds, Ce, Gs^Fds, Gs, Gs^Vht, Re, Re, Gs, Gs^Fp, Re, Ss, Rb, Ss, Gll^Fp, Gll^Fp, Gll^Fp, Ss, Ss, Rb, Rb, Ss, Ss, Gll^Fp, Gll^Fmw, Ss, Gll^Fp, Gll^Fp, Ss, Co, Co, Rb, Rb, Rrd, Rrd, Ds
Gs^Fds, Gs^Fds, Gs^Fds, Gs^Fds, Gs^Fds, Gs^Fds, Gs, Re, Sm, Re, Gll^Fp, Gll^Fp, Ss, Rb, Sm, Sm, Gll^Fp, Gll^Fp, Rb, Rb, Ss, Ss^Fp, Ss, Gll^Fmw, Gll^Fp, Gll^Fmw, Gll^Fmw, Ss, Ss, Co, Co, 4 Ko, Rb, Rb, Ds^Vd, Rrd, Ds
Ss, Ss, Gs^Fds, Gs^Fds, Re, Re, Sm, Sm, Gll^Fp, Sm, Sm, Rb, Ss, Rb, Rb, Ss, Gll^Fp, Gll^Fp, Rb, Rb, Ss, Ss, Ss, Ss, Gll^Fmw, Gll^Fp, Gll^Fdw, Ss, Ss, Ss, Ss, Co, Rb, Rb, Ds, Ds, Ds
Gs^Fds, Ss, Ss, Gs^Fds, Gs^Fds, Re, Gll^Fp, Gll^Fp, Gll^Fp, Sm, Rb, Rb, Rb, Ss, Ss, Rb, Rb, Rb, Gll^Fp, Gll^Fp, Ss, Ss, Sm, Ss^Vhs, Ss, Gll^Fmw, Ss, Ss, Ss^Vhs, Ss, Ss, Ds, Ds, Rb, Rrd, Ds, Ds
Gs^Fds, Ss, Ss, Ss^Vhs, Ss, Re, Rb, Gll^Fp, Rb, Rb, Rb, Sm, Rb, Ss, Ss, Ss, Ss, Gll^Fp, Gll^Fp, Gll^Fp, Ss, Ss, Sm, Sm, Ss, Ss, Ss, Ss, Ss, Ss, Ds, Ds, Rb, Rb, Rrd, Rrd, Ds
Gs, Gs, Ss, Ss, Ss, Ss, Ss, Rb, Sm, Sm, Gll^Fp, Sm, Rb, Ss, Ss^Vht, Ss, Ss, Ss, Ss, Ss, Ss, Sm, Ss, Ss, Gll^Fmw, Gll^Fdw, Rrd, Ss, Ss, Ss, Ds, Ds, Rb, Rrd, Rrd, Ds, Ds
Gs, Re, Ss, Ss, Ss, Gs^Fds, Gs^Fds, Sm, Sm, Gll^Fp, Gll^Fp, Sm, Sm, Rb, Rb, Ss, Rb, Ss, Rb, Ss, Ss, Ss, Gll^Fmw, Gll^Fmw, Gll^Fp, Gll^Fmw, Rrd, Rrd, Rrd, Ds, Rrd, Rrd, Rb, Rrd^Vd, Rrd, Ds, Rrd
Re, Re, Re, Sm, Sm, Gs^Fds, Gs^Fds, Sm, Rb, Sm, Gll^Fp, Gll^Fp, Gll^Fp, Sm, Sm, Rb, Sm, Rb, Rb, Rb, Rb, Rb, Rb, Rb, Rb, Rrd, Rrd, Rrd, Rrd, Rrd, Rrd, Rrd, Rrd, Rb, Rrd, Rrd, Rrd
Ss, Sm, Ss^Vhs, Sm, Ss, Sm, Gs^Fds, Gs^Fds, Ss, Sm, Sm, Rb, Gll^Fp, Sm, Sm, Sm, Ss, Sm, Sm, Sm^Vhs, Gll^Fp, Gll^Fp, Gll^Fmw, Ss, Rrd, Rb, Rb, Rrd, Rb, Rb, Rb, Rrd, Rb, Rb, Rrd, Rrd, Rrd
Ss, Ss, Rb, Sm, Sm, Sm, Rb, Sm, Ss^Vhs, Ss, Sm, Rb, Sm, Gll^Fp, Sm, Ss, Sm, Ss, Sm, Sm, Sm, Gll^Fp, Gll^Fmw, Ss, Ss, Rrd, Rrd, Rb, Co^Edb, Co^Edb, Co^Edb, Rb, Rrd, Rrd, Rrd, Rrd, Ds
Ss, Ss, Sm, Gs^Fds, Gs^Fds, Sm, Rb, Sm, Sm, Ss, Rb, Rb, Sm, Sm, Sm, Sm, Sm, Sm, Sm, Ss, Gll^Fmw, Sm, Sm, Ss, Ss, Rrd, Rrd, Rb, Co^Edb, Co^Edb, Co^Edb, Rb, Rrd, Ds, Ds, Ds, Sm
Ss, Ss, Ss, Ss, Ss, Ss, Ss, Sm, Sm, Sm, Rb, Ss, Sm, Gll^Fmw, Gll^Fp, Sm, Ss^Vhs, Sm, Sm, Gll^Fmw, Gll^Fp, Gll^Fmw, Sm, Sm, Ss^Vhs, Rrd, Rrd, Rb, Rb, Co^Edb, Rb, Rb, Rrd, Ds, Ds, Sm, Sm
Ss, Ss, Gs^Fds, Ss, Sm, Ss^Vhs, Ss, Ss, Sm, Rb, Sm, Ss, Ss^Vhs, Gll^Fmw, Gll^Fp, Sm, Sm, Ss, Ss, Gll^Fmw, Gll^Fmw, Gll^Fp, Gll^Fmw, Sm, Sm, Ss, Ds, Rrd, Ds, Rb, Rrd, Rrd, Rrd, Rrd, Sm, Sm, Sm
Ss, Sm, Ss, Gs^Fds, Gs, Ss, Ss, Ss, Rb, Rb, Ss, Ss, Sm, Gll^Fmw, Gll^Fp, Gll^Fmw, Gll^Fmw, Sm, Sm, Ss, Gll^Fmw, Re, Gll^Fp, Sm, Sm, Ss, Ss, Ds, Ds, Rrd, Rrd, Rrd, Sm, Rrd, Sm, Sm, Sm
Ss, Ss, Gs^Fds, Gs^Fds, Gs^Fds, Gs, Gs, Rb, Ss, Sm, Ss, Ss, Sm, Gll^Fmw, Gll^Fmw, Gll^Feth, Gll^Fp, Sm, Sm, Ss, Ss, Re, Sm, Sm, Ss, Sm, Ss, Ds, Sm, Sm, Sm, Sm, Sm, Sm, Sm, Sm, Sm
Ss, Ss, Gs^Fds, Gs^Fds, Gs^Fds, Gs^Fds, Re, Ss, Ss, Sm, Sm, Sm, Ss, Sm, Sm, Gll^Fmw, Sm, Gll^Fmw, Sm, Sm, Co, Co, Co, Sm, Sm, Ss, Sm, Ss, Sm, Sm, Ss, Sm, Ss, Sm, Sm, Sm, Sm
Ss, Gs^Fds, Ss, Ss, Ss, Ss, Re, Ss, Sm, Sm, Ss, Sm, Sm, Sm, Ss, Sm, Ss, Sm, Sm, Ss, Sm, 5 Ko, Ss, Sm, Ss, Ss, Sm, Ss, Ss, Sm, Sm, Ss, Sm, Sm, Sm, Sm, Sm
Ss, Ss, Ss, Ss, Ss, Ss, Re, Ss, Ss, Ss, Ss, Ss, Ss, Sm, Sm, Ss, Ss, Ss, Ss, Ss, Sm, Co, Sm, Ss, Ss, Sm, Sm, Sm, Ss, Sm, Sm, Sm, Ss, Sm, Sm, Sm, Sm
