Gs, Gs, Gs^Fds, Gs^Fds, Gs^Fms, Ss, Ss, Ss, Ss, Ss, Ss, Ss, Ss, Ss, Ss, Ss, Ss, Ss, Ss, Ss, Ss, Ss, Co, Co, Co, Ss, Gll^Fp, Hh, Hhd, Hhd, Xue, Xue, Xue, Xu, Xue, Xue, Xue
Gs, Gs, Gs^Efm, Gs, Rd, Gs^Fms, Ss, Ss, Ss^Edt, Gll^Fp, Gd^Fp, Ss, Ss^Vhs, Ss, Gll^Fp, Gll^Fp, Gll^Fp, Ss^Vhs, Ss, Ss, Ss, Ss, Co, Co, Co, Ss, Gd^Fp, Gll^Fp, Gll^Fp, Hhd, Hhd, Xue, Xue, Xue, Xue, Xue, Hhd
Gs^Fds, Gs, Gs^Fms, Gs^Fms, Rd, Ss, Ss, Ss, Ss, Ss, Gll^Fmw, Gll^Fp, Re, Ss, Ss, Gll^Fp, Gll^Fdw, Gd^Fp, Gd^Fp, Ss^Edt, Ss^Edt, Ss, Co, 3 Ko, Co^Es, Ss, Gd^Fmw, Gd^Fdw, Gll^Fp, Hhd, Sm^Ewl, Hhd, Sm, Uue, Hhd, Hhd, Hhd
Gs^Fds, Gs, Gs^Efm, Gs, Rd, Rd, Rd, Ss^Vhs, Ss, Ss, Rd, Gll^Fmw, Gll^Fp, Re, Ss, Gd^Fp, Gd^Fmw, Gll^Fp, Ss^Edt, Ss^Edt, Ss, Ss, Rd^Esd, Rd, Ss, Ss, Gll^Fmw, Gll^Feth, Gd^Fmw, Ss, Ss, Sm, Rrd, Rrd, Dd^Do, Hd, Hd
Gs, Gs, Gd, Gs^Vht, Gs, Gs^Fms, Rd, Rd, Gs, Rd, Rd, Ss, Ss, Re, Ss, Ss, Gll^Fp, Gll^Fmw, Gll^Fp, Ss^Vht, Ss, Ss, Rd, Rd, Ss^Ewl, Ss, Ss, Gll^Fp, Gll^Fmw, Ss, Ss, Sm, Rrd, Rrd, Rrd, Hd, Hd
Gs, Gd, Ce, Gs, Ce, Gs, Gs^Efm, Gs^Fp, Gd, Gs, Rd, Rd, Rd, Ss, Re, Ss, Rd, Gd^Fp, Re, Re, Ss, Ss, Gll^Fmw, Re, Re, Ss, Ss, Gd^Fp, Ss, Ss, Ss, Ss, Ss, Sm, Rrd, Hd, Hd
Gd, Gs, 2 Ke, Ce, Gs, Gs^Fms, Gs^Fms, Gd, Gs^Vht, Gs^Fp, Gs, Gs, Gs, Gs^Fp, Gll^Fp, Rd, Gd^Fp, Re, Ss, Ss, Ss, Ss, Gd^Fmw, Gd^Fp, Gll^Fp, Rd, Ss, Ss, Ss, Ss, Rd^Esd, Ss, Rrd, Rrd, Hd, Hd, Hd
Gs, Gs, Gg, Gg, Gs, Gs^Efm, Gs, Gs, Gs^Fp, Gs^Fp, Gs, Gs^Fp, Rd, Gs^Fp, Gll^Fp, Gll^Fmw, Gll^Fp, Re^Em, Re, Ss^Vhs, Rd, Gll^Fmw, Re, Re, Re, Rd^Edt, Ss^Bw\r, Re, Rd, Rd^Esd, Rd, Rd^Esd, Rrd, Hd, Hd, Dd^Vd, Hd
Gs, Gs, 1 Ke, Ce, Ce, Gs, Gs^Fms, Gs^Fms, Gs^Fp, Gs^Efm, Gs, Gs^Fp, Rd, Gs^Fp, Ss^Vhs, Gd^Fmw, Gll^Fmw, Re^Em, Ss, Rd, Gll^Fp, Rd, Ss, Ss^Vhs, Gd^Fp, Ss, Gll^Fmw, Rd^Edt, Gd^Fmw, Gd^Fp, Gll^Fp, Rrd^Es, Rrd, Dd, Dd^Dc, Dd^Esd, Dd
Gs^Fds, Gs^Fds, Gs^Fds, Ce, Gs^Fds, Gs, Gs^Vht, Rd, Rd, Gs, Gs^Fp, Rd, Ss, Rd, Ss, Gll^Fp, Gd^Fmw, Gll^Fmw, Ss, Ss, Rd, Rd, Ss, Ss, Gd^Fmw, Gll^Fmw, Ss, Gll^Fmw, Gd^Fp, Ss, Cd, Cd, Rrd, Dd, Dd, Dd^Esd, Dd
Gs^Fds, Gs^Fds, Gs^Fds, Gs^Fds, Gs^Fms, Gs^Fds, Gs, Rd, Sm, Rd, Gll^Fp, Gll^Fmw, Ss, Re, Sm^Ewl, Sm, Gll^Fp, Gll^Fp, Re, Ss^Bw/r, Ss, Gd^Fp, Ss, Gll^Fp, Gll^Fp, Gll^Fmw, Gll^Fp, Ss, Ss, Cdr^Es, Cdr, 4 Kdr, Rrd, Dd^Esd, Rrd^Vd, Hd, Hd
Ss, Ss, Gs^Fds, Gs^Fms, Rd, Rd, Sm, Sm, Gll^Fp, Sm, Sm, Rd, Ss, Re, Rd, Ss, Gd^Fmw, Gll^Fp, Re, Re^Es, Ss, Ss, Ss, Ss, Gd^Fp, Gll^Fmw, Gll^Fp, Ss, Ss, Ss, Ss, Cd, Rrd^Es, Rrd^Es, Hd, Hd, Hd
Gs^Fms, Ss, Ss, Gs^Fms, Gs^Fms, Rd, Gll^Fp, Gll^Fmw, Gll^Fp, Sm, Rd, Rd, Re^Em, Ss, Ss, Rd, Rd, Rd, Gd^Fp, Gll^Fmw, Ss, Ss, Sm^Ewl, Ss^Vhs, Ss, Gll^Fp, Ss, Ss, Ss^Vhs, Ss, Ss, Rrd, Rrd^Es, Rrd, Hd, Hd, Hd
Gs^Fms, Ss, Ss, Ss^Vhs, Ss, Rd, Rd, Gll^Fmw, Rd, Rd, Sm^Bw|r, Sm, Re, Ss, Ss, Ss, Ss, Gd^Fp, Gd^Fmw, Gd^Fmw, Ss, Ss, Sm, Sm, Ss, Ss, Ss, Ss, Ss, Ss, Dd, Dd, Dd, Rrd, Hd, Hd, Hd
Gs, Gs, Ss, Ss, Ss, Ss, Ss, Rd, Sm, Sm, Gd^Fp, Sm, Re, Ss, Ss^Vht, Ss, Ss, Ss, Ss, Ss, Ss, Sm, Ss, Ss, Gll^Fdw, Gd^Fp, Dd^Edpp, Ss, Ss, Ss, Dd, Dd, Rrd, Rrd, Hd, Hd, Hd
Gs, Re, Ss, Ss, Ss, Gs^Fds, Gs^Fms, Sm^Edt, Sm, Gd^Fmw, Gd^Fmw, Sm, Sm, Rd, Ss^Bw\r, Ss, Rd, Ss, Re, Ss, Ss, Ss, Gll^Fp, Gll^Fmw, Gd^Fp, Gll^Fmw, Dd, Dd, Dd^Esd, Dd, Dd^Esd, Dd, Rrd, Rrd^Vd, Hd, Hd, Hd
Re, Re, Re, Sm, Sm, Gs^Fms, Gs^Fds, Sm, Re, Sm, Gd^Fp, Gll^Fmw, Gll^Fmw, Sm, Sm^Edt, Rd, Sm, Rd, Re, Re^Esd, Re, Re, Re^Esd, Re^Esd, Rrd, Dd, Dd^Esd, Dd^Do, Dd, Dd^Esd, Dd, Rrd, Hd, Hd, Hd, Hd, Hd
Ss, Sm, Ss^Vhs, Sm, Ss, Sm, Gs^Fms, Gs^Fms, Ss, Sm, Sm, Re^Em, Gd^Fmw, Sm, Sm, Sm^Ewl, Ss, Sm, Sm, Sm^Vhs, Gll^Fmw, Gll^Fmw, Gd^Fmw, Ss, Dd, Rrd, Rrd, Dd, Rrd, Rrd, Rrd^Es, Rrd^Es, Hd, Hd, Hd, Hd, Dd
Ss, Ss^Em, Re^Em, Sm^Em, Sm, Sm, Re^Em, Sm, Ss^Vhs, Ss, Sm, Re, Sm^Ewl, Gll^Fp, Sm, Ss, Sm^Ewl, Ss, Sm, Sm, Sm, Gd^Fp, Gll^Fmw, Ss, Ss, Dd^Esd, Dd^Esd, Rrd^Es, Cdr^Es, Cdr, Cdr^Es, Rrd^Dr, Hd, Hd, Dd^Dc, Dd, Dd
Ss, Ss, Sm, Gs^Fms, Gs^Fds, Sm, Re, Sm, Sm, Ss, Rd, Rd, Sm, Sm, Sm, Sm, Sm, Sm, Sm, Ss, Gd^Fmw, Sm, Sm, Ss, Ss, Dd, Dd, Rrd, Cdr^Es, Cdr^Es, Cdr, Rrd^Es, Hd, Dd^Esd, Dd, Dd^Esd, Ss
Ss, Ss, Ss, Ss, Ss, Ss, Ss, Sm^Ewf, Sm, Sm, Rd, Ss, Sm, Gd^Fp, Gll^Fp, Sm, Ss^Vhs, Sm, Sm, Gll^Fp, Gll^Fdw, Gd^Fp, Sm, Sm, Ss^Vhs, Dd, Dd, Rrd, Rrd^Es, Cdr^Es, Rrd, Rrd^Es, Dd^Esd, Dd^Edpp, Dd, Ss, Sm
Ss, Ss, Gs^Fds, Ss, Sm, Ss^Vhs, Ss, Ss, Sm, Rd, Sm, Ss, Ss^Vhs, Gll^Fp, Gll^Fp, Sm, Sm, Ss, Ss, Gll^Fp, Gd^Fmw, Gll^Fp, Gll^Fmw, Sm, Sm, Ss, Dd, Dd^Esd, Dd^Esd, Rrd, Dd, Dd, Dd, Dd, Ss, Ss, Sm
Ss, Sm, Ss, Gs^Fms, Gs^Efm, Sm, Ss, Ss, Sm^Bw/r, Rd, Ss, Ss, Sm, Gd^Fp, Gll^Fdw, Gd^Fmw, Gll^Fp, Sm, Sm, Ss, Gll^Fp, Re^Em, Gll^Fmw, Sm^Ewl, Sm, Ss, Ss, Dd, Dd, Dd^Edpp, Dd, Dd, Ss, Dd, Ss, Sm, Sm
Ss, Ss, Gs^Fms, Gs^Fds, Gs^Fms, Gs^Efm, Gs, Re, Ss, Sm, Ss, Ss, Sm, Gll^Fp, Gd^Fmw, Gll^Feth, Gd^Fmw, Sm, Sm, Ss, Ss, Re, Sm, Sm, Ss, Sm, Ss, Dd, Ss, Ss, Ss, Ss, Sm, Ss, Sm, Sm, Sm^Ewl
Ss, Ss, Gs^Fds, Gs^Fms, Gs^Fds, Gs^Fms, Re, Ss, Ss, Sm, Sm, Sm, Ss, Sm, Sm, Gd^Fmw, Sm, Gll^Fp, Sm, Sm, Co, Co^Es, Co, Sm, Sm, Ss, Sm, Ss, Sm, Sm, Ss, Sm, Ss, Sm, Sm, Sm^Ewf, Sm^Ewl
Ss, Gs^Fds, Ss, Ss, Ss, Ss, Re, Ss, Sm, Sm, Ss, Sm, Sm, Sm, Ss, Sm, Ss, Sm, Sm, Ss, Sm, 5 Ko, Ss, Sm, Ss, Ss, Sm, Ss, Ss, Sm, Sm, Ss, Sm, Sm, Sm^Ewl, Sm^Ewl, Sm^Ewl
Ss, Ss, Ss, Ss, Ss, Ss, Re, Ss, Ss, Ss, Ss, Ss, Ss, Sm, Sm, Ss, Ss, Ss, Ss, Ss, Sm, Co, Sm, Ss, Ss, Sm, Sm, Sm, Ss, Sm, Sm, Sm, Sm, Sm^Ewl, Sm^Ewl, Sm^Ewl, Sm
