Xu, Xu, Xu, Xu, Xu, Xu, Xu, Xu, Xu, Xu, Xu, Xu, Xu, Xu, Xu, Xu, Xu, Xu, Xu, Xu, Xu, Xu, Xu
Xu, Xu, Xu, Xu, Xu, Xu, Xu, Xu, Xu, Xu, Uu, Xu, Uu, Xu, Xu, Xu, Xu, Xu, Xu, Xu, Xu, Xu, Xu
Xu, Xu, Xu, Xu, Xu, Xu, Xu, Xu, Xu, Xu, Uu, 3 Rd, Uu, Xu, Xu, Xu, Xu, Xu, Xu, Xu, Xu, Xu, Xu
Xu, Xu, Xu, Xu, Xu, Xu, Xu, Xu, Xu, Xu, Uu, Rd, Uu, Xu, Xu, Xu, Xu, Xu, Xu, Xu, Xu, Xu, Xu
Xu, Xu, Xu, Xu, Xu, Xu, Xu, Xu, Xu, Xu, Uu, Rd^Es, Uu, Xu, Xu, Xu, Uh, Xu, Xu, Xu, Xu, Xu, Xu
Xu, Xu, Xu, Xu, Xu, Xu, Uh, Xu, Uu^Tf, Uh, Uu, Uu, Uu^Ii, Uh, Uh, Xu, Uh, Xu, Xu, Xu, Xu, Xu, Xu
Xu, Xu, Xu, Xu, Xu, Xu, Uh, Xu, Uu, Uh, Uu, Uu, Uu^Ii, Uh, Uu^Tf, Uh, Uh, Xu, Xu, Xu, Xu, Xu, Xu
Xu, Xu, Xu, Xu, Xu, Xu, Uh, Uh, Uu^Ii, Uu, Uu, Rd, Uu, Uu, Uu, Uu^Vu, Uh, Xu, Xu, Xu, Xu, Xu, Xu
Xu, Xu, Xu, Xu, Xu, Xu, Uh, Uu^Vu, Uu^Ii, Ce, 1 Ke, Rd, 2 Ke, Ce, Uu, Uu^Ii, Uh, Xu, Xu, Xu, Xu, Xu, Xu
Xu, Xu, Xu, Xu, Xu, Uh, Uh, Uu, Uu^Ii, Ce, Ce, Rd, Ce, Ce, Uu^Ii, Uu^Ii, Uu^Tf, Xu, Xu, Xu, Xu, Xu, Xu
Xu, Xu, Xu, Xu, Xu, Uh, Uu^Tf, Uh, Rd, Rd, Uu, Rd, Rd, Uu, Uh, Uu^Ii, Rd, Uu^Tf, Xu, Uh, Xu, Xu, Xu
Xu, Xu, Uh, Xu, Xu, Uh, Uh, Uu^Tfi, Rd, Uh, Uh, Uu, Uu^Ii, Uu, Uu, Rd, Xu, Uu, Uh, Uh, Uh, Xu, Xu
Xu, Xu, Uh, Uh, Uh, Uh, Uh, Uu, Uu, Uu, Uu^Tfi, Uu^Ii, Uu^Vu, Rd, Rd, Rd, Xu, Xu, Uu, Uh, Uh, Xu, Xu
Xu, Xu, Xu, Uh, Xu, Xu, Uu^Tfi, Rd, Rd, Rd, Rd, Rd, Uh, Uh, Rd^Ii, Uu^Ii, Xu, Xu, Uu^Tf, Uh, Uh, Xu, Xu
Xu, Xu, Uu, Uu, Xu, Xu, Uu^Tf, Uu, Rd^Ii, Uu, Uu, Uu, Uh, Uh, Rd^Es, Uu^Es, Uu^Tfi, Uu, Xu, Xu, Uu, Xu, Xu
Xu, Xu, Xu, Uu, Xu, Xu, Xu, Uu^Ii, Uh, Uh, Xu, Xu, Uu, Rd^Ii, Uu, Uu, Uu^Tf, Uh, Uh, Xu, Uu, Xu, Xu
Xu, Xu, Xu, Uu, Uh, Xu, Xu, Uu, Uu^Tf, Uu, Uu, Uu, Uu, Uu, Uh, Uu, Uu^Es, Uh, Xu, Uh, Uh, Xu, Xu
Xu, Xu, Xu, Xu, Uh, Uh, Uh, Uu, Uu, Uu, Rd^Es, Rd, Uu, Uu, Xu, Uh, Uh, Xu, Xu, Uh, Xu, Xu, Xu
Xu, Xu, Xu, Xu, Uh, Uh, Uu^Tf, Uh, Uu^Tf, Uu, Rd^Es, Uu, Xu, Xu, Xu, Uh, Uu, Uh, Xu, Uu^Tf, Xu, Xu, Xu
Xu, Xu, Xu, Uh, Xu, Uh, Uu, Uu^Tf, Uu, Uu^Es, Rd^Es, Uu, Xu, Xu, Uu, Uh, Uu^Es, Xu, Uu, Uu^Tf, Uu^Tf, Xu, Xu
Xu, Xu, Xu, Xu, Xu, Uh, Uu^Tf, Uu, Uu, Uu^Es, Uu, Uu^Tf, Xu, Xu, Uu, Uu^Tf, Uh, Uu^Es, Uh, Xu, Xu, Xu, Xu
Xu, Xu, Xu, Xu, Xu, Uh, Uh, Uu^Tf, Uu, Rd^Es, Uu, Xu, Xu, Xu, Xu, Uu, Uh, Uu, Uh, Xu, Xu, Xu, Xu
Xu, Xu, Xu, Xu, Xu, Uh, Uh, Uu, Uu, Rd, Uu, Xu, Xu, Xu, Xu, Uu, Uh, Uh, Uh, Xu, Xu, Xu, Xu
