Xu, Xu, Xu, Xu, Xu, Xu, Xu, Xu, Xu, Gg, Xu, Xu, Xu, Xu, Xu, Xu, Xu, Xu, Xu
Xu, Xu, Xu, Xu, Xu, Xu, Xu, Xu, Uu, Gg^Pr|, Uu, Xu, Xu, Xu, Uh, Xu, Xu, Xu, Xu
Xu, Xu, Xu, Uh, Xu, Xu, Uu, Xu, Uu, 3 Rd, Uu, Xu, Uh, Uh, Xu, Xu, Xu, Xu, Xu
Xu, Xu, Xu, Uh, Uh, Uh, Uu, Uu, Uu, Rd, Uu, Uh, Uh, Uh, Uu, Xu, Xu, Xu, Xu
Xu, Xu, Xu, Uh, Uh, Uh, Uu, Uu^Vu, Uu, Uu, Uu, Uh, Uu, Uu, Uu^Tf, Uu^Tf, Xu, Xu, Xu
Xu, Xu, Uh, Uh, Uu, Uh, Ce, Uu, Ce, Rd, Ce, Uu, Ce, Uu, Uu^Vu, Uu, Uh, Xu, Xu
Xu, Xu, Uu, Uh, Uu, Uu, Ce, 1 Ke, Ce, Rd, Ce, 2 Ke, Ce, Uu, Uu, Uh, Uh, Xu, Xu
Xu, Xu, Uu, Uh, Uu^Vu, Uu, Uu, Uu, Rd^Es, Rd, Uu, Uu, Uu, Uu, Uh, Uh, Uh, Xu, Xu
Xu, Xu, Xu, Uu, Uu^Tf, Uu, Uu, Rd, Uu, Rd, Uu, Uu^Vu, Uh, Uh, Uh, Uh, Xu, Xu, Xu
Xu, Xu, Xu, Uu^Tf, Uu, Uu, Uu^Tf, Uu, Uu, Rd, Rd, Uu, Uu, Uu, Uh, Uh, Xu, Xu, Xu
Xu, Xu, Xu, Uu^Tf, Uu^Tf, Uu, Uu, Uu^Vu, Uh, Uu, Uu, Rd, Uu, Uu, Uh, Uh, Xu, Xu, Xu
Xu, Xu, Xu, Xu, Xu, Uu, Uh, Uh, Uu, Uu, Uu, Uu, Uu^Vu, Uu^Tf, Xu, Uh, Xu, Xu, Xu
Xu, Xu, Xu, Xu, Uh, Uh, Uh, Uh, Uu^Tf, Uu^Tf, Rd, Rd, Uu^Tf, Uu^Tf, Xu, Xu, Xu, Xu, Xu
Xu, Xu, Xu, Uh, Xu, Uh, Xu, Uh, Uu, Rd, Uu, Uu, Xu, Xu, Xu, Xu, Xu, Xu, Xu
Xu, Xu, Xu, Uh, Uh, Xu, Xu, Uh, Uu, Uu, Uu, Uu^Tf, Xu, Xu, Xu, Xu, Xu, Xu, Xu
Xu, Xu, Xu, Xu, Xu, Uh, Uh, Uh, Uu, Uu, Uu, Uu^Tf, Xu, Xu, Xu, Xu, Xu, Xu, Xu
Xu, Xu, Xu, Xu, Xu, Xu, Xu, Xu, Uu, Rd, Uu, Xu, Xu, Xu, Xu, Xu, Xu, Xu, Xu
Xu, Xu, Xu, Xu, Xu, Xu, Xu, Xu, Uu, Rd, Uu, Xu, Xu, Xu, Xu, Xu, Xu, Xu, Xu
Xu, Xu, Xu, Xu, Xu, Xu, Xu, Xu, Uu, Rd, Uu, Xu, Xu, Xu, Xu, Xu, Xu, Xu, Xu
