Xu, Xu, Xu, Xu, Xu, Xu, Xu, Xu, Xu, Gg, Xu, Xu, Xu, Xu, Xu, Xu, Xu, Xu, Xu
Xu, Xu, Xu, Xu, Xu, Xu, Xu, Xu, Uu, Gg^Pr|, Uu, Xu, Xu, Xu, Uh, Xu, Xu, Xu, Xu
Xu, Xu, Xu, Uh, Xu, Xu, Uu, Xu, Uu, 3 Rd, Uu, Xu, Uh, Uh, Xu, Xu, Xu, Xu, Xu
Xu, Xu, Xu, Uh, Uh, Uh, Uu, Uu, Uu, Rd, Uu, Uh, Uh, Uh, Uu, Xu, Xu, Xu, Xu
Xu, Xu, Xu, Uh, Uh, Uh, Uu, Uu^Vu, Uu, Rd, Uu, Uh, Uu, Uu, Uu^Tf, Uu^Tf, Xu, Xu, Xu
Xu, Xu, Uh, Uh, Uu^Ii, Uh, Ce, Uu, Ce, Rd, Ce, Uu, Ce, Rd^Em, Uu, Uu^Vu, Uh, Xu, Xu
Xu, Xu, Uu, Uh, Rd^Es, Uu, Ce, 1 Ke, Ce, Rd, Ce, 2 Ke, Ce, Rd, Uu^Ii, Uh, Uh, Xu, Xu
Xu, Xu, Uu^Vu, Uh, Uu, Rd, Uu, Uu, Rd^Es, Rd, Uu, Uu, Uu, Uu^Ii, Uh, Uh, Uh, Xu, Xu
Xu, Xu, Xu, Uu, Uu^Tfi, Uu, Uu, Rd, Uu^Ii, Rd, Uu, Uu^Vu, Uh, Uh, Uh, Uh, Xu, Xu, Xu
Xu, Xu, Xu, Uu^Tf, Rd^Em, Rd, Uu^Tf, Uu^Ii, Uu, Rd, Rd^Es, Uu, Uu, Uu, Uh, Uh, Xu, Xu, Xu
Xu, Xu, Xu, Uu^Tf, Uu^Tf, Rd, Uu, Uu, Uh, Uu, Uu, Rd, Uu, Uu, Uh, Uh, Xu, Xu, Xu
Xu, Xu, Xu, Xu, Xu, Uu, Uh, Uh, Uu, Uu, Uu, Uu, Uu, Uu^Tf, Xu, Uh, Xu, Xu, Xu
Xu, Xu, Xu, Xu, Uh, Uh, Uh, Uh, Uu^Tf, Uu^Tf, Rd, Rd, Uu^Tf, Uu^Tf, Xu, Xu, Xu, Xu, Xu
Xu, Xu, Xu, Uh, Xu, Uh, Xu, Uh, Uu, Rd^Em, Uu, Uu, Xu, Xu, Xu, Xu, Xu, Xu, Xu
Xu, Xu, Xu, Uh, Uh, Xu, Xu, Uh, Uu, Uu, Uu^Vu, Uu^Tf, Xu, Xu, Xu, Xu, Xu, Xu, Xu
Xu, Xu, Xu, Xu, Xu, Uh, Uh, Uh, Uu, Uu, Uu, Uu^Tf, Xu, Xu, Xu, Xu, Xu, Xu, Xu
Xu, Xu, Xu, Xu, Xu, Xu, Xu, Xu, Uu, Rd, Uu, Xu, Xu, Xu, Xu, Xu, Xu, Xu, Xu
Xu, Xu, Xu, Xu, Xu, Xu, Xu, Xu, Uu, Rd, Uu, Xu, Xu, Xu, Xu, Xu, Xu, Xu, Xu
Xu, Xu, Xu, Xu, Xu, Xu, Xu, Xu, Uu, Rd, Uu, Xu, Xu, Xu, Xu, Xu, Xu, Xu, Xu
