Xu, Xu, Xu, Xu, Xu, Xu, Xu, Xu, Xu, Gg, Xu, Xu, Xu, Xu, Xu, Xu, Xu, Xu, Xu
Xu, Xu, Xu, Xu, Uh, Xu, Xu, Xu, Exos, Re^Pr|, Exos, Xu, Xu, Xu, Xu, Xu, Xu, Xu, Xu
Xu, Xu, Xu, Xu, Uh, Xu, Xu, Xu, Uu, 3 Rd, Uu, Xu, Xu, Xu, Xu, Xu, Xu, Xu, Xu
Xu, Xu, Xu, Xu, Rd^Es, Uu, Uh, Xu, Uu^Ii, Rd, Uu, Xu, Xu, Xu, Xu, Xu, Xu, Xu, Xu
Xu, Xu, Xu, Uu, Uu^Es, Uu^Ii, Uh, Uu^Vu, Uu^Es, Rd, Uu, Uu^Tfi, Uu^Tfi, Uu^Tf, Uu^Emf, Xu, Xu, Xu, Xu
Xu, Xu, Xu, Uu^Ii, Rd, Rd^Ii, Rd, Rd^Es, Rd^Es, Rd^Es, Uu, Rd, Rd, Rd^Em, Rd^Em, Uu^Vu, Xu, Xu, Xu
Xu, Xu, Xu, Uh, Rd, Ce, Ce, 1 Ke, Ce, Rd, Ce, 2 Ke, Ce, Ce, Rd, Uu^Ii, Uh, Xu, Xu
Xu, Xu, Xu, Uh, Uu^Es, Rd^Es, Rd^Es, Uu^Ii, Rd, Rd^Es, Rd^Es, Rd, Rd^Ii, Uu, Uu^Vu, Rd^Es, Uh, Xu, Xu
Xu, Xu, Uu^Tf, Rd^Em, Uh, Uu^Vu, Uu, Rd^Es, Uu^Vu, Rd^Ii, Uu^Ii, Uu^Ii, Uh, Uh, Rd^Em, Rd, Uh, Xu, Xu
Xu, Xu, Uu, Rd^Emf, Xu, Xu, Xu, Rd^Ii, Uh, Rd^Es, Uu^Ii, Uh, Qxu, Qxu, Uu^Ii, Uu^Tf, Xu, Uh, Xu
Xu, Xu, Uh, Uu, Rd, Rd^Em, Rd, Uu^Ii, Uh, Rd^Es, Uu^Vu, Qxu, Rd^Es, Qxu, Rd^Es, Uu^Ii, Xu, Xu, Xu
Xu, Xu, Xu, Uh, Uh, Uu^Tf, Uu^Tf, Uu, Uu, Rd, Uu, Rd^Es, Uh^Ii, Rd, Uu, Uu^Ii, Uh, Xu, Xu
Xu, Xu, Xu, Uu, Uu^Em, Xu, Xu, Uh, Uu^Ii, Rd^Ii, Uh, Uh, Qxu, Qxu, Rd, Uu, Uh, Xu, Xu
Xu, Xu, Xu, Rd^Em, Uu^Tf, Xu, Xu, Uh, Uu^Vu, Rd, Uu^Ii, Uu, Qxu, Qxu, Rd, Uu, Xu, Xu, Xu
Xu, Xu, Xu, Rd^Emf, Xu, Xu, Xu, Uh, Uu, Rd, Uu, Uu^Tf, Qxu, Qxu, Uh, Uu, Xu, Xu, Xu
Xu, Xu, Xu, Xu, Xu, Xu, Xu, Xu, Uu, Rd, Uu, Qxu, Qxu, Qxu, Qxu, Uh, Xu, Xu, Xu
Xu, Xu, Xu, Xu, Xu, Xu, Xu, Xu, Co, Co, Co, Qxu, Qxu, Qxu, Qxu, Uh, Qxu, Xu, Xu
Xu, Xu, Xu, Xu, Xu, Xu, Xu, Xu, Co, 4 Ko, Co, Qxu, Qxu, Qxu, Qxu, Qxu, Qxu, Xu, Xu
Xu, Xu, Xu, Xu, Xu, Xu, Xu, Xu, Uu, Rd, Uu, Qxu, Qxu, Qxu, Qxu, Qxu, Qxu, Xu, Xu
