Mm, Mm, Mm, Mm, Mm, Mm, Mm, Mm, Mm, Mm, Mm, Mm, Hhd^Fp, Hhd^Fp, Hhd^Fp, Gg, Gd, Hhd, Hhd, Hh, Mm, Mm, Mm, Mm, Mm, Mm, Mm, Mm, Mm, Mm, Mm, Mm, Mm, Mm, Mm, Mm, Mm, Mm
Mm, Mm, Mm, Mm, Mm, Mm, Mm, Mm, Mm, Mm, Mm, Hhd^Fp, Hhd^Fp, Hhd^Fp, Gll^Fp, Gg, Gd, Hhd, Hh, Hh, Mm, Mm, Mm, Mm, Mm, Mm, Mm, Mm, Mm, Mm, Mm, Mm, Mm, Mm, Mm, Mm, Mm, Mm
Mm, Mm, Mm, Mm, Mm, Mm, Mm, Mm, Mm, Mm, Mm, Hhd^Fp, Hhd^Fp, Hhd^Fp, Gll^Fp, Gg, Gd, Hhd, Hh, Mm, Mm, Mm, Mm, Mm, Mm, Mm, Mm, Mm, Mm, Mm, Mm, Mm, Mm, Mm, Mm, Mm, Mm, Mm
Mm, Mm, Mm, Mm, Mm, Mm, Mm, Mm, Mm, Mm, Mm, Mm, Hhd^Fp, Hhd^Fp, Gll^Fp, Gg, Gd, Hhd, Hhd, Hh, Mm, Mm, Mm, Mm, Mm, Mm, Mm, Mm, Mm, Mm, Mm, Mm, Mm, Mm, Mm, Mm, Mm, Mm
Mm, Mm, Mm, Mm, Mm, Mm, Mm, Mm, Mm, Mm, Mm, Hhd^Fp, Hhd^Fp, Gll^Fp, Gg^Ve, Gg, Gd, Hhd, Hhd, Hhd, Hhd, Hh, Hhd, Mm, Mm, Mm, Mm, Mm, Mm, Mm, Mm, Mm, Mm, Mm, Mm, Mm, Mm, Mm
Mm, Mm, Mm, Mm, Mm, Hhd, Hhd, Hhd, Hh, Mm, Gg, Hhd^Fp, Gll^Fp, Gg, Gg, Gg, Hd, Hd, Ww, Wwf, Ww, Hhd, Hd, Hhd, Hhd, Gd, Gg^Efm, Gg, Gg, Mm, Mm, Mm, Mm, Mm, Mm, Mm, Mm, Mm
Hhd, Hhd, Hd, Hhd, Hd, Hd, Ww, Ww, Ww, Ww, Ww, Ww, Ww, Ww, Ww, Ww, Ww, Ww, Ww, Ww, Ww, Ww, Ww, Hd, Gd, Gd, Gg, Gg, Gg, Gg, Gg, Gg, Hh, Hh, Hhd, Mm, Mm, Mm
Ds, Ds, Ds, Ds, Ww, Ww, Ww, Ww, Ww, Ww, Ww, Ww, Ww, Ww, Ww, Ww, Ww, Ww, Ww, Ww, Ww, Ww, Ww, Ww, Ww, Ww, Ww, Ds, Ds, Gg, Ds, Gg, Gg, Hh, Hhd, Mm, Mm, Mm
Ww, Ww, Ww, Ww, Ww, Ww, Ww, Ww, Ww, Ww, Ww, Ww, Ww, Ww, Ww, Ww, Ww, Ww, Ww, Ww, Ww, Ww, Ww, Ww, Ww, Ww, Ww, Ww, Ww, Ww, Ww, Ww, Ww, Ww, Hd, Hhd, Hd, Hd
Wwr, Ww, Ww, Ww, Ww, Ww, Ww, Ww, Ww, Ww, Gd, Hhd^Fp, Hhd^Fp, Ww, Ww, Ww, Ww, Ww, Ww, Ww, Ww, Ww, Gg, Gg, Gg^Efm, Ww, Ww, Ww, Ww, Ww, Ww, Ww, Ww, Ww, Ww, Ww, Ww, Ww
Wo, Wo, Wo, Ww, Ww, Ww, Ww, Ww, Ww, Gg, Gg^Efm, Gd, Gg, Ww, Ww, Ww, Ww, Ww, Ww, Ww, Ww, Hh, Gd, Gd, Gg, Ww, Ww, Ww, Ww, Ww, Wo, Wo, Wo, Wo, Wo, Wo, Wo, Wo
Ww, Ww, Ww, Ww, Ww, Ww, Ww, Ww, Ww, Ww, Ww, Ww, Ww, Ww, Ww, Ww, Ww, Ww, Ww, Ww, Ww, Ww, Gll^Fp, Gll^Fp, Ww, Ww, Ww, Ww, Ww, Ww, Ww, Ww, Ww, Ww, Ww, Ww, Ww, Ww
Ww, Ww, Ww, Ww, Ww, Ww, Ww, Ww, Ww, Ww, Ww, Ww, Ww, Ww, Ww, Ww, Ww, Ww, Ww, Ww, Ww, Ww, Ww, Ww, Ww, Ww, Ww, Ww, Ww, Hd, Hd, Hd, Hhd, Hd, Hhd, Hd, Hd, Hd
Mm, Gg^Ve, Hhd, Hd, Hhd, Ww, Ww, Ww, Ww, Ww, Ww, Ww, Ww, Hh, Hhd, Hd, Hhd, Hh, Ww, Ww, Ww, Ww, Ww, Ww, Ww, Ww, Hhd, Hd, Hhd, Hhd, Hhd, Hhd, Hh, Hhd, Hh, Hhd, Hhd, Hhd
Mm, Mm, Hh, Hhd, Hh, Mm, Mm, Mm, Ww, Hhd, Hhd, Hhd, Hhd, Hhd, Gs^Fms, Gll^Fp, Gll^Fp, Gll^Fp, Gs^Fms, Hhd^Fp, Gs^Fms, Mm, Mm, Mm, Gll^Fp, Hhd, Mm, Mm, Mm, Mm, Mm, Mm, Mm, Hh^Vhh, Mm, Mm, Mm, Mm
Hhd^Fp, Hhd^Fp, Gll^Fp, Hh, Gg^Ve, Gll^Fp, Hhd^Fp, Kvr, Cvr, Gll^Fp, Gs^Fms, Gll^Fp, Gll^Fp, Gll^Fp, Hh^Fp, Gll^Fp, Gll^Fp, Hhd^Fp, Gs^Fms, Gs^Fms, Hhd^Fp, Gll^Fp, Hhd^Fp, Mm, Hhd, Hhd, Mm, Mm, Mm, Mm, Mm, Mm, Mm, Mm, Mm, Mm, Mm, Mm
Hhd^Fp, Hhd^Fp, Gs^Fms, Gll^Fp, Gll^Fp, Gll^Fp, Gs^Fms, Cvr, Gs^Fms, Gll^Fp, Hh^Fp, Mm, Mm, Mm, Mm, Mm, Mm, Mm, Mm, Mm, Mm, Mm, Mm, Hh^Vhh, Hhd, Mm, Mm, Mm, Mm, Mm, Mm, Mm^Vhh, Mm, Mm, Mm, Mm, Mm, Mm
Hhd^Fp, Hhd^Fp, Gll^Fp, Gg, Gg, Gs^Fms, Gs^Fms, Gll^Fp, Hh^Fp, Gs^Fms, Gs^Fms, Hh, Hh^Fp, Hh, Hh, Mm, Mm, Mm, Mm, Mm, Mm, Mm, Mm, Mm, Hhd, Hh, Hh, Mm, Mm, Mm, Mm, Mm, Mm, Hh, Hh, Mm, Mm, Mm
Hhd^Fp, Hhd^Fp, Hhd^Fp, Gll^Fp, Gg, Gg, Gg, Hhd, Hhd, Hhd, Re, Re, Gll^Fp, Gll^Fp, Gll^Fp, Hh, Hh, Hh, Hhd, Gll^Fp, Gll^Fp, Hhd^Fp, Gll^Fp, Hhd^Fp, Mm, Mm, Mm, Mm, Mm, Mm, Mm, Mm, Hh, Hh, Mm, Hh, Mm, Mm
Mm, Mm, Mm, Mm, Gg^Ve, Mm, Hh, Hh, Hhd, Hhd, Hhd, Hhd, Gd, Re, Re, Gg^Ve, Re^Gvs, Hh, Hh, Hhd, Hhd, Hhd, Hhd, Mm, Mm, Mm, Mm, Mm^Vhh, Mm, Mm, Hh, Hh, Hh, Mm, Mm, Mm, Mm, Mm
Mm, Mm, Mm, Mm, Mm, Mm, Mm, Hhd, Hhd, Hhd^Fp, Hhd, Hhd, Hhd, Hhd, Hh, Re^Gvs, Re^Gvs, Hh, Hh, Hh, Hh, Mm, Mm, Mm, Mm, Mm, Mm, Mm, Mm, Mm, Hh, Hh, Mm, Mm, Mm, Mm, Mm, Mm
Mm, Mm, Mm, Mm, Mm, Hhd^Fp, Gll^Fp, Gll^Fp, Gll^Fp, Gll^Fp, Gll^Fp, Gll^Fp, Gg, Hh, Hh, Hh, Hh, Hh, Hh, Hh, Hh, Hh, Hh, Mm, Mm, Mm, Mm, Mm, Mm, Hh, Mm, Mm, Mm, Mm, Mm, Mm, Mm, Mm
Mm, Mm, Mm, Mm, Gll^Fp, Gll^Fp, Hhd^Fp, Gll^Fp, Hhd^Fp, Hhd^Fp, Gll^Fp, Mm, Hh, Gg, Gg, Gg, Gd, Hhd, Hhd, Mm, Mm, Mm, Mm, Mm, Mm, Mm, Hh, Mm, Mm, Mm, Mm, Mm, Mm, Mm, Mm, Mm, Mm, Mm
Mm, Mm, Mm, Mm, Mm, Mm, Mm, Mm, Mm, Gg, Gg, Gg, Gg, Gs, Gg, Gd, Hhd^Fp, Gll^Fp, Hhd^Fp, Gg^Ve, Mm, Mm, Mm, Mm, Mm, Mm, Mm, Mm, Mm, Mm, Mm, Mm, Mm, Mm, Mm, Mm, Mm, Mm
Mm, Mm, Mm, Mm, Mm, Mm, Mm, Mm, Hh^Vhh, Mm, Gd, Gd, Gd, Gd, Gd, Gd, Gd, Gd, Gd, Gs, Gg, Gs, Gs, Hh, Mm, Mm, Mm, Mm, Gll^Fp, Mm, Mm, Mm, Mm, Mm, Mm, Mm, Mm, Mm
Hhd, Mm, Mm, Mm, Mm, Mm, Mm, Mm, Hhd, Hhd, Hhd, Hhd, Hhd, Hhd, Gs^Fms, Rp, Gs^Vc, Gs^Fds, Gs^Fds, Hhd, Hhd, Hh, Hh, Hh, Hh, Hh^Vhh, Hh, Hhd, Hhd, Mm, Mm, Mm, Mm, Mm, Mm, Mm, Mm, Mm
Hhd, Hhd, Hhd, Mm, Mm, Mm^Vhh, Hhd, Gll^Fp, Gll^Fp, Hhd^Fp, Gll^Fp, Hhd^Fp, Gs^Fds, Gd, Re, Gs^Fms, Hhd, Hhd, Mm, Gs^Fds, Hhd^Fp, Hhd, Hhd, Hhd, Hhd, Hhd, Hh, Mm, Mm, Hhd, Hhd, Hhd, Hhd, Ce, Ce, Ce, Mm, Mm
Hhd, Ce, Ce, Ce, Hhd, Hhd, Mm, Mm, Mm, Hhd, Hhd, Hhd, Hhd, Gs^Fms, Gs^Fms, Gs^Fms, Gs^Fds, Gs^Fds, Gs^Fds, Gs^Fms, Gs^Fms, Gs^Fds, Hhd, Hhd, Mm, Hhd, Mm, Mm, Mm, Mm, Mm, Mm, Hhd, Ce, 4 Ke, Ce, Mm, Mm
Hhd, Ce, 3 Ke, Ce, Mm, Mm, Mm, Mm, Mm, Mm, Mm, Mm, Gd, Gd, Gd^Efm, Gd, Gd, Gd, Gd, Gs^Fds, Gs^Fds, Gs^Fds, Gs^Fds, Gs^Fds, Gs^Efm, Gd, Gd, Hhd, Hhd, Mm, Mm, Mm, Hhd, Ce, Ce, Ce, Mm, Mm
Hhd, Ce, Ce, Ce, Mm, Mm, Mm, Mm^Vhh, Mm, Mm, Mm, Mm, Gs^Fds, Hh^Fp, Gs^Fms, Gs^Fds, Gs^Fms, Gs^Fds, Gs^Fms, Gs^Fds, Gs^Fds, Gs^Vc, Gs^Fds, Gs^Fds, Gs^Fds, Gs^Fds, Hh^Fp, Mm, Hhd, Gs^Fds, Gs^Fds, Gs^Fds, Gs^Fds, Mm, Mm, Mm, Mm, Mm
Mm, Hhd, Hhd, Mm, Mm^Vhh, Mm, Mm, Mm, Mm, Mm, Gs^Vc, Mm, Mm, Gs^Fms, Gs^Fds, Gs^Fms, Gs^Fds, Gs^Fms, Gs^Fms, Gs^Fms, Gs^Fms, Gs^Fds, Gs^Fds, Gs^Fms, Gs^Fms, Gs^Fds, Gs^Fds, Gs^Vc, Gd, Gg^Ve, Gs^Fds, Gs^Fds, Gd^Fet, Gs^Fds, Gs^Fds, Mm, Mm, Mm
Mm, Mm, Mm, Mm, Mm, Mm, Mm, Hhd^Fp, Gs^Fds, Gs^Fds, Gs^Fds, Gs^Fds, Gs^Fds, Gs^Fds, Gs^Fms, Gs^Vc, Gs^Fds, Gs^Fds, Gs^Fms, Gs^Fds, Gs^Fms, Gs^Fds, Gg, Gg, Gs^Fms, Gs^Fms, Gs^Fds, Gs^Fds, Gs^Fds, Mm, Hhd, Hhd, Hhd, Hhd, Hhd, Mm, Mm, Mm
Hhd, Hhd, Mm, Mm, Mm, Mm, Gs^Vc, Gs^Fds, Gs^Fds, Hhd^Fp, Gs^Fds, Gs^Fms, Gg^Fet, Gs^Fms, Gg, Gs^Fms, Gs^Fms, Gs^Fms, Gs^Fds, Gs^Fms, Gs^Fms, Gs^Fms, Gs^Fms, Gs^Fms, Gs^Fms, Gs^Fds, Gs^Fds, Gs^Fds, Gs^Vc, Mm, Mm, Mm, Mm, Mm, Mm, Mm, Mm, Mm
Mm, Mm, Mm, Mm, Mm, Mm, Mm, Mm, Hhd^Fp, Gs^Fds, Gs^Vc, Gs^Fds, Gs^Fms, Gs^Fds, Gs^Fds, Gs^Fms, Gs^Fds, Gs^Fds, Gs^Fds, Gs^Fds, Gs^Fds, Gs^Fds, Gs^Fds, Gs^Fms, Gs^Fds, Gs^Fms, Gs^Fms, Gs^Fds, Gs^Fds, Gs^Fds, Hhd^Fp, Hhd^Fp, Mm, Mm, Mm, Mm, Mm, Mm
Mm, Mm, Mm, Mm, Mm, Mm, Mm, Hhd, Hhd, Hhd^Fp, Gs^Fds, Gs^Fds, Gs^Fds, Gs^Fds, Gs^Fds, Gs^Fds, Ce, Ce, Ce, Gs^Fds, Ce, Ce, Ce, Gs^Fds, Gs^Fds, Gs^Fds, Gs^Fds, Gs^Fds, Hhd^Fp, Mm, Mm, Mm, Mm, Mm, Mm, Mm, Mm, Mm
Mm, Mm, Mm, Mm, Mm, Mm, Mm, Hhd, Hhd, Hhd^Fp, Hhd^Fp, Gs^Fms, Gs^Efm, Gs^Fms, Gs^Fds, Gs^Fds, Ce, 1 Ke, Ce, Gs^Fds, Ce, 2 Ke, Ce, Gs^Fds, Gs^Fds, Gg, Gs^Fds, Gs^Fds, Hhd^Fp, Mm, Mm, Mm, Mm, Mm, Mm, Mm, Mm, Mm
Mm, Mm, Mm, Mm, Mm, Mm, Mm, Hhd, Hhd, Hhd^Fp, Hhd^Fp, Gs^Fds, Gs^Fds, Gs^Fds, Gs^Fds, Gs^Fds, Gs^Fds, Gs^Fds, Gs^Fms, Gs^Fds, Gs^Fds, Gs^Fms, Gs^Fms, Gs^Fds, Gs^Fms, Gs^Fms, Hhd^Fp, Hhd^Fp, Hhd^Fp, Mm, Mm, Mm, Mm, Mm, Mm, Mm, Mm, Mm
Mm, Mm, Mm, Mm, Mm, Mm, Mm, Hhd, Hhd, Gll^Fp, Hhd^Fp, Gs^Fds, Gs^Fds, Gs^Fds, Gs^Fds, Gs^Fds, Gs^Fds, Gs^Fds, Gs^Fds, Gs^Fds, Gs^Fds, Gs^Fms, Gs^Fds, Gs^Efm, Gs^Fds, Gs^Fds, Gs^Fds, Hhd^Fp, Hhd^Fp, Mm, Mm, Mm, Mm, Mm, Mm, Mm, Mm, Mm
