Mm, Mm, Mm, Mm, Mm, Mm, Mm, Mm, Mm, Mm, Mm, Mm, Mm, Mm, Mm, Mm, Mm, Mm, Gd, Gg, Gg, Gs^Fms, Mm, Mm, Mm, Mm, Mm, Mm, Mm, Mm, Mm, Mm, Mm, Mm, Mm, Mm, Mm, Ww
Mm, Mm, Mm, Mm, Mm, Mm, Hhd, Mm, Hhd, Mm, Hh^Fms, Hh^Fms, Hh^Fms, Mm, Mm, Mm, Mm, Mm, Gd, Gg, Hh^Fp, Gll^Fp, Hh^Fp, Hh^Fp, Hhd, Mm, Mm, Mm, Hhd, Mm, Mm, Mm, Hhd, Hhd, Hhd, Mm, Hhd, Hhd
Hhd, Mm, Hhd, Mm, Hd, Mm, Ww, Hhd, Hd, Hd, Ww, Ww, Hh^Fms, Hh^Fms, Mm, Mm, Mm, Mm, Gd, Gg, Hh^Fp, Ww, Ww, Ww, Ww, Ww, Mm, Hhd, Ww, Hhd, Ww, Ww, Ww, Ww, Hd, Hd, Ww, Ww
Hd, Mm, Hhd, Hd, Ww, Ww, Ww, Ww, Ww, Ww, Ww, Ww, Hh^Fms, Mm, Mm, Mm, Ww, Gd, Ww, Ww, Ww, Ww, Ww, Ww, Ww, Ww, Ww, Ww, Ww, Ww, Ww, Ww, Ww^Es, Ww, Ww, Ww, Ww, Ww
Hd, Hhd, Ww, Hd, Ww, Ww, Ww, Ww, Ww, Ww, Ww, Ww, Ww, Ww, Ww, Ww, Ww, Ww, Ww, Ww, Ww, Ww, Ww, Ww, Ww, Wo, Wo, Wo, Ww, Ww, Ww, Ww, Ww, Ww, Ww, Ww, Ww, Ww
Ww, Ww, Ww, Ww, Ww, Ww, Ww, Ww, Ww, Ww, Wo, Ww, Wo, Ww, Ww, Ww, Ww, Ww, Ww, Ww, Ww, Ww, Ww, Wo, Wo, Wo, Ww, Wo, Ww, Ww, Ww, Ww, Ww, Ww, Ww, Ww, Ww, Ww
Ww, Ww, Ww, Ww, Ww, Ww, Ww, Ww, Ww, Wo, Ww, Wo, Ww, Ww, Ww^Es, Ww, Ww, Ww, Ww, Ww, Wo, Ww, Ww, Ww, Ww, Ww, Ww, Ww, Ww, Ww, Ww, Ww, Wo, Ww, Wo, Wo, Wo, Wo
Ww, Ww, Wo, Ww, Wo, Ww, Ww, Ww, Ww, Ww, Ww, Ww, Ww, Ww, Ww, Ww, Wo, Wo, Wo, Wo, Wo, Ww, Hh^Fds, Ww, Ww, Ww, Ww, Ww, Wo, Ww, Wo, Wo, Wo, Wo, Wo, Wo, Wo, Wo
Wo, Wo, Wo, Wo, Wo, Wo, Wo, Wo, Wo, Wo, Ww, Ds, Hh^Fds, Ww, Ww, Ww, Wo, Wo, Wo, Wo, Wo, Ww, Hh, Hh^Fds, Hd, Ww, Wo, Wo, Wo, Wo, Ww, Wo, Ww, Wo, Ww, Wo, Ww, Ww
Wo, Wo, Wo, Wo, Ww, Wo, Wo, Ww, Ww, Ww, Ww, Hhd, Ds, Ww, Ww, Wo, Ww, Wo, Ww, Ww, Ww, Ww, Ww, Ww, Ww, Ww, Ww, Ww, Ww, Ww, Ww, Ww, Ww, Ww, Ww, Ww, Ww, Ww
Ww, Wo, Ww, Ww, Ww, Ww, Ww, Ww, Ww, Ww, Ww, Ww, Ww, Ww, Ww, Ww, Ww, Ww, Ww, Ww, Ww, Ww, Ww, Ww, Ww, Ww, Ww, Ww, Ww, Ww, Ww, Ww, Ww, Ww, Ww, Ww, Ww, Ww
Ww, Ww, Ww, Ww, Ww, Ww, Ww^Es, Ww, Ww, Ww, Ww, Ww, Ww, Ww, Ww, Ww, Ww, Ww, Ww, Ww, Ww, Ww, Ww, Ww, Ww, Ww, Ww^Es, Ww, Ww, Ww, Ww, Ww, Ww, Ww, Ww, Ww, Ww, Ww
Ww, Ww, Ww, Ww, Ww, Ww, Ww, Ww, Ww, Ww, Ww, Ww, Ww, Ww, Ww, Ww, Ww, Ww, Ww, Ww, Ww, Ww, Ww, Ww, Ww, Ww, Ww, Ww, Ww, Ds, Ds, Ds, Ds, Ds, Hd, Hd, Ds, Ds
Hd, Hd, Hd, Ds, Ds, Ww, Ww, Ww, Ww, Ww, Ww, Ww, Ww, Hd, Mm, Mm, Mm, Hd, Ww, Ww, Ww, Ww, Ww, Ww, Ww, Ww, Hd, Hd, Hd, Hd, Hhd, Hhd, Hh, Hh, Hhd, Hhd, Hhd, Hhd
Hh, Hh, Hh, Hh, Hh, Ds, Mm, Mm, Ww, Mm, Hh, Ds, Ds, Hd, Mm, Mm, Hhd, Hd, Hd, Hd, Ds, Ds, Ds, Ds, Hd, Hd, Hh, Hh, Mm, Mm, Mm, Hh^Fp, Hh^Fp, Hh^Fp, Mm, Mm, Mm, Mm
Mm, Mm, Hhd, Hh, Mm, Hh, Hhd, Cvr, Kvr, Cvr, Hh, Gs, Mm, Mm, Mm, Mm, Mm, Hhd, Hhd^Fp, Hh^Fp, Mm, Mm, Mm, Hh, Hh, Hh, Hh, Mm, Mm, Mm, Hh^Fp, Hh^Fp, Hhd, Hh, Mm, Mm, Mm, Mm
Mm, Mm, Mm, Mm, Gg^Ve, Hh, Hhd, Cvr, Gd, Cvr, Gs, Gs, Hh, Mm, Mm, Mm, Mm, Mm, Mm, Hhd^Fp, Hh^Fp, Mm, Mm, Mm, Mm, Mm, Mm, Mm, Mm, Mm, Hh^Vhh, Hhd, Hhd, Mm, Mm, Mm, Mm, Mm
Mm, Mm, Mm, Hhd^Fmw, Hh^Fms, Hh^Fp, Gs, Gd^Es, Gd, Gs, Gg, Gg, Gg^Ve, Hh^Fp, Hh^Fp, Mm, Mm, Mm, Mm, Mm, Hd, Hh^Fp, Mm, Mm, Mm, Mm, Mm, Mm, Mm, Mm, Mm, Mm, Mm, Hhd, Mm, Mm, Mm, Mm
Mm, Mm, Mm, Hhd^Fp, Mm, Hh^Fp, Hh^Fp, Gs, Gd, Gs, Gs, Gs, Re^Gvs, Re^Gvs, Hhd, Hhd, Mm, Mm, Mm, Mm, Hhd, Hd, Mm, Mm, Mm, Mm, Mm, Mm, Mm, Mm, Hd, Mm, Mm, Mm, Mm, Mm, Mm, Mm
Mm, Mm, Mm, Mm, Mm, Hh^Fms, Hhd, Gs^Ve, Hhd, Gs, Hh, Hh, Hh, Re^Gvs, Hh, Mm, Hh, Hhd, Hhd, Hhd^Vhh, Hhd, Hd, Mm, Mm, Mm, Mm, Hhd, Mm, Hhd, Hd, Hhd, Mm, Mm, Mm, Mm, Mm, Mm, Mm
Mm, Mm, Mm, Mm, Mm, Mm, Mm, Hhd, Mm, Hhd, Mm, Mm, Hh, Hh, Hh, Hh, Hh, Hh, Hh, Hhd, Hhd, Mm, Hh^Fp, Hh^Fp, Hh, Hh, Hhd^Fp, Hh^Vhh, Hhd, Hhd, Mm, Mm, Mm, Mm, Mm, Mm, Mm, Mm
Mm, Mm, Mm, Mm, Mm, Mm, Mm, Mm, Mm, Mm, Mm, Hh, Hh^Fp, Hh^Fp, Hh, Gs, Gd, Gs, Hh, Hh, Hhd, Hh^Fp, Gll^Fms, Hh^Fmw, Hh^Fmw, Hhd^Fp, Mm, Mm, Hhd, Mm, Mm, Mm, Mm, Mm, Mm, Mm, Mm, Mm
Mm, Mm, Mm, Mm, Mm, Mm, Mm, Mm, Mm, Mm, Hh^Fms, Gg^Ve, Gg, Hh, Gll^Fms, Gd, Gs, Gs, Gs, Gs^Fp, Gs^Fmw, Gd^Fet, Hh^Fp, Hh^Fmw, Hh^Fp, Hh^Fp, Mm, Mm, Mm, Mm, Mm, Mm, Mm, Mm, Mm, Mm, Mm, Mm
Mm, Mm, Mm, Mm, Mm, Mm, Hhd^Vhh, Mm, Hh, Hh^Fms, Hh^Fp, Hh^Fp, Gs^Fmw, Gs^Fp, Hh^Fms, Gs, Hh, Hh, Hh, Gs^Fms, Gs^Fms, Gs^Fms, Gg^Ve, Hh^Fp, Mm, Mm, Mm, Mm, Mm, Mm, Mm, Mm, Mm, Mm, Mm, Mm, Mm, Mm
Mm, Mm, Mm, Mm, Mm, Mm, Hhd^Fms, Hhd, Hh^Fms, Hh^Fp, Hh, Hh^Fms, Hh, Hh, Re^Gvs, Re^Gvs, Gs^Ve, Hh, Hh^Fp, Hh^Fms, Hhd, Hhd, Mm, Mm, Mm, Mm, Mm, Mm, Hhd^Vhh, Mm, Mm, Mm, Mm, Mm, Mm, Mm, Mm, Mm
Mm, Mm, Mm, Mm, Hhd^Fms, Hhd^Fms, Mm, Hhd, Mm, Mm, Gd^Es, Hh, Gd, Gg, Gs, Re^Gvs, Re^Gvs, Hh, Hhd, Hh, Mm, Mm, Mm, Mm, Mm, Mm, Mm, Hhd, Hhd, Mm, Mm, Mm, Mm, Mm, Mm, Mm, Mm, Mm
Mm, Mm, Mm, Mm, Mm, Mm, Mm, Mm, Mm, Gd, Gd, Gd, Gs, Gs, Gs, Gs, Gg, Gg, Gg, Hh, Hh, Mm, Hh, Hhd, Hh, Hhd^Fms, Hhd^Fms, Hhd^Fms, Hhd, Mm, Mm, Mm, Mm, Mm, Mm, Mm, Mm, Mm
Mm, Mm, Mm, Mm, Mm, Mm, Mm, Mm, Mm, Mm, Hh^Fms, Gs^Fms, Gs^Fds, Gs, Gs^Fds, Gs^Fms, Gs^Fds, Gg, Hh, Hh, Gs^Vc, Hh, Gs, Hh, Gs^Fds, Hhd^Fms, Hh, Hhd^Fms, Mm, Hhd, Mm, Mm, Mm, Mm, Mm, Mm, Mm, Mm
Mm, Mm, Mm, Mm, Mm, Mm, Mm, Mm, Mm, Mm, Hh^Fms, Hh^Fms, Hh, Gs^Fds, Re^Gvs, Gs^Fds, Gs^Fds, Gg, Gg, Gs, Gg, Gs, Gd, Gd, Gs^Fds, Hh, Mm, Hh^Fms, Mm, Mm, Mm, Mm, Mm, Mm, Mm, Mm, Mm, Mm
Mm, Mm, Hh^Vhh, Mm, Mm, Mm, Mm, Mm, Hhd^Fms, Hhd, Hh^Fms, Hh, Gs^Fds, Gg, Gg, Gg^Ve, Gs^Fds, Gs^Fds, Gs^Fds, Gg, Gs^Fds, Gs^Fds, Gs^Fms, Gs^Fds, Hh, Hh^Fds, Mm, Mm, Mm, Mm, Mm, Mm, Mm, Mm, Mm, Hh^Vhh, Mm, Mm
Mm, Mm, Mm, Mm, Mm, Mm, Hhd^Fms, Hhd^Fms, Gs^Vc, Hh, Hh, Hh^Fds, Hh^Fds, Gs^Fds, Gs^Fds, Gs^Fds, Gs^Fds, Gs^Fmw, Gs^Fds, Gg, Gs^Fds, Gs^Fms, Gs^Es, Gs^Fds, Gs^Fds, Gs^Vc, Hh, Hh^Fds, Hh, Mm, Mm, Mm, Mm, Mm, Mm, Mm, Mm, Mm
Mm, Mm, Mm, Mm, Mm, Mm, Mm, Hh^Fds, Hh, Gs^Fds, Gs^Vc, Gs^Fds, Gs^Fds, Gs^Fds, Gs^Fms, Gs^Fds, Gs^Fmw, Gs^Fds, Gs^Fds, Gs^Fds, Gs^Fms, Gs^Fms, Gs^Fms, Gs^Fds, Gg^Ve, Hh^Fds, Hh^Fds, Hh, Gs^Vc, Mm, Hhd, Hhd, Mm, Mm, Mm, Mm, Mm, Mm
Mm, Mm, Ce, Mm, Mm, Mm, Hhd^Fds, Hhd^Fms, Gs^Fms, Gs^Fds, Gs^Fds, Gs^Fms, Gs^Fms, Gd^Fet, Gs^Fds, Gs^Fmw, Gs^Fds, Gs^Fds, Gs^Fds, Gs^Fms, Gs^Fds, Gs^Fmw, Gs^Fms, Gs^Fms, Gs^Fms, Gs^Fms, Gs^Fds, Gs^Fds, Hhd, Hhd, Hh, Mm, Mm, Mm, Mm, Mm, Mm, Mm
Mm, Ce, 3 Ke, Ce, Mm, Mm, Mm, Mm, Gs^Fds, Gs^Fms, Gs^Fmw, Gs^Fms, Gs^Efm, Gs^Fms, Gg^Ve, Gs^Fds, Gs^Fds, Gs^Fds, Gs^Fms, Gs^Fms, Gs^Fds, Gs^Fds, Gs^Fds, Gs^Fms, Gs^Fds, Gs^Fms, Gs^Fds, Gs^Fds, Gs^Fds, Hh^Fms, Mm, Mm, Mm, Mm, Ce, Ce, Ce, Mm
Mm, Ce, Ce, Ce, Mm, Mm, Mm, Mm, Mm, Hh, Gs^Fds, Gs^Fms, Gs^Fms, Gs^Fms, Gs^Fms, Gs^Fds, Ce, Gs^Fds, Ce, Gs^Fds, Ce, Gs^Fds, Ce, Gs^Fds, Gs^Fds, Gs^Fmw, Gs^Fds, Gs^Fds, Hh, Mm, Hh, Mm, Mm, Mm, Ce, 4 Ke, Ce, Mm
Mm, Ce, Mm, Ce, Mm, Mm, Mm, Mm, Hhd, Gs^Vc, Gs^Fds, Gs^Fds, Gs^Fds, Gs^Fds, Gs^Fms, Gs^Fds, Ce, 1 Ke, Ce, Gs^Fds, Ce, 2 Ke, Ce, Gs^Fds, Gs^Fms, Gs^Fms, Gs^Fms, Gs^Fds, Gs^Vc, Hhd^Fds, Mm, Mm, Mm, Mm, Ce, Ce, Ce, Mm
Mm, Mm, Mm, Mm, Hhd^Fds, Mm, Hhd^Fms, Hhd^Fms, Hhd, Gs^Fds, Hhd, Gs^Fms, Gs^Fms, Gs^Fms, Gs^Fmw, Gs^Fds, Gs^Fds, Gs^Fds, Gs^Fds, Gs^Fds, Gs^Fds, Gs^Fds, Gs^Fds, Gs^Fms, Gs^Fms, Gs^Efm, Gs^Fms, Gs^Fms, Gs^Fms, Hhd^Fds, Hhd^Fds, Mm, Hhd^Fds, Mm, Mm, Mm, Mm, Mm
Mm, Mm, Mm, Hhd^Fds, Mm, Mm, Hh, Hhd^Fds, Hhd^Fds, Hhd^Fds, Hh^Fds, Hh^Fds, Gs^Fds, Gs^Fds, Gs^Fds, Gs^Fds, Gs^Fds, Gs^Fds, Gs^Fds, Gs^Fds, Gs^Fds, Gs^Fds, Gs^Fds, Gs^Fms, Gs^Fds, Gs^Fms, Gs^Fds, Gs^Fms, Hh, Hhd^Fds, Hhd, Mm, Mm, Mm, Mm, Mm, Mm, Mm
