Mm, Mm, Mm, Re, Re, Gg, Hhd, Hhd, Mm, Mm, Mm, Mm, Mm, Mm, Mm, Mm, Mm, Mm, Mm, Mm, Mm, Mm, Ha, Mm, Mm, Mm, Mm, Mm, Mm, Mm, Mm, Mm, Mm, Mm, Mm, Mm, Mm, Mm, Mm, Mm, Mm, Mm, Mm, Mm, Cea, Cea, Cea, Mm
Mm, Mm, Mm, Mm, Re, Gg, Hhd, Hhd, Hhd, Mm, Mm, Mm, Mm, Mm, Mm, Mm, Mm, Mm, Mm, Mm, Mm, Mm, Ha, Mm, Mm, Mm, Mm, Mm, Mm, Mm, Ha, Ha, Ha, Mm, Mm, Mm, Mm, Mm, Mm, Mm, Mm, Mm, Mm, Mm, Cea, 5 Kea, Cea, Mm
Mm, Mm, Mm, Aa^Vca, Re, Gg, Aa, Aa, Mm, Mm, Mm, Hhd, Hhd, Mm, Mm, Mm, Mm, Mm, Mm, Mm, Mm, Ha, Mm, Mm, Mm, Mm, Mm, Ha, Mm, Ha, Wwt, Wwt, Ha, Ha, Ha, Mm, Mm, Mm, Mm, Ha^Vhha, Mm, Mm, Mm, Hh, Cea, Cea, Cea, Mm
Mm, Mm, Mm, Re^Gvs, Mm, Re, Cea, Cea, Cea, Mm, Gg, Mm, Hh, Hh, Mm, Mm, Mm, Mm, Mm, Mm, Ha, Ha, Mm, Ha^Vhha, Mm, Mm, Mm, Ha, Wwt, Wwt, Wwt, Wwt, Wwt, Wwt, Ha, Mm, Ha, Mm, Ha, Mm, Mm, Mm, Gg, Hh, Hh, Mm, Mm, Mm
Mm, Mm, Mm, Mm, Mm, Mm, Cea, 4 Kea, Cea, Cea, Gg, Mm, Re^Gvs, Gs^Vh, Mm, Mm, Mm, Mm, Gll^Fp, Mm, Mm, Mm, Mm, Mm, Mm, Mm, Ha, Ha, Wwt, Wwt, Wot, Wot, Wwt, Wwt, Ai, Ha, Mm, Ha, Mm, Mm, Hh, Hh, Gg, Gg, Mm, Mm, Mm, Mm
Mm, Mm, Mm, Mm, Mm, Mm, Aa, Cea, Re, Gg, Gg, Re^Gvs, Mm, Mm, Gll^Fp, Mm, Gg^Ve, Gll^Fp, Gll^Fp, Gll^Fp, Mm, Mm, Mm, Mm, Mm, Mm, Ha, Ai, Wwt, Wwt, Wot, Wot, Wot, Wwt, Wwt, Ha, Mm, Mm, Mm, Mm, Hh, Re^Gvs, Re^Gvs, Gg, Gll^Fp, Mm, Hhd, Mm
Mm, Mm, Mm, Mm, Mm, Mm, Aa, Cea, Gg, Re, Mm, Mm, Mm, Mm, Mm, Gll^Fp, Gll^Fp, Gll^Fp, Gll^Fp, Mm, Mm, Mm, Mm, Mm, Mm, Ha, Ha, Ai, Wwt, Wwt, Wwt, Wot, Wwt, Wwt, Ww, Mm, Mm, Mm, Mm, Mm, Mm, Mm, Mm, Aa^Vca, Gll^Fmf, Hhd, Mm, Mm
Mm, Mm, Mm, Mm, Hh^Vhh, Mm, Mm, Gg, Gg, Re, Re, Mm, Hh, Hh, Mm, Mm, Gll^Fp, Gll^Fp, Gs, Gs^Vh, Re^Gvs, Mm, Mm, Mm, Ha, Ha, Gll^Fp, Gll^Fp, Gll^Fp, Ww, Ww, Wwt, Wwt, Wwt, Ww, Ww, Ai, Gg, Re^Gvs, Gs^Vh, Gg, Gg, Mm, Gs, Gll^Fmf, Hh^Fp, Mm, Mm
Mm, Mm, Mm, Mm, Mm, Hh, Hh, Re^Gvs, Re^Gvs, Gll^Fp, Re, Gll^Fp, Hh^Fp, Mm, Mm, Mm, Gll^Fmf, Gll^Fp, Gs, Re^Gvs, Gll^Fp, Mm, Mm, Mm, Mm, Mm, Gll^Fp, Gll^Fmw, Gll^Fp, Ww, Ww, Ww, Ww, Ww, Ww, Ww, Ai, Gg, Gg, Re^Gvs, Gg, Gll^Fp, Gs^Es, Gs, Gll^Fmf, Mm, Mm, Hhd
Mm, Mm, Mm, Mm, Mm, Hh, Hh, Gs^Vh, Gll^Fmw, Gll^Fp, Re, Gll^Fp, Gll^Fp, Gll^Fp, Mm, Mm, Gll^Fp, Gll^Fp, Re, Re, Re, Re, Re, Re, Re, Gs^Vc, Re, Gll^Fmf, Gll^Fp, Gll^Fp, Ww, Ww, Ww, Ww, Ww, Ai, Ai, Ai, Ai, Gll^Fp, Gll^Fp, Gg, Gg, Hh, Gll^Fp, Hh, Hh, Hhd
Mm, Mm, Ha, Ha, Ha, Mm, Ha, Ha, Aa, Gll^Fp, Re, Gll^Fp, Gll^Fp, Mm, Mm, Mm, Hh, Re, Gll^Fmf, Gll^Fmf, Gll^Fmw, Gll^Fp, Gll^Fp, Gll^Fp, Gll^Fp, Re, Gll^Fp, Re, Re, Gll^Fp, Ww, Ww, Gll^Fp, Ww, Ai, Ai, Gll^Fp, Ai, Gll^Fp, Gll^Fmf, Re^Gvs, Gg, Gll^Fp, Gg, Gg^Ve, Hh^Fp, Hh, Gll^Fmf
Mm, Ha, Mm, Mm, Mm, Ha, Gll^Fp, Gll^Fp, Gll^Fp, Gs^Vc, Re^Gvs, Re, Re, Gll^Fp, Mm, Mm, Re, Re, Gll^Fp, Gll^Fmf, Ww, Gll^Fmf, Ww, Gll^Fp, Gll^Fp, Gll^Fp, Gll^Fp, Gll^Fp, Gll^Fp, Ww^Bw\, Re, Gll^Fp, Gll^Fmf, Gll^Fp, Gll^Fp, Gll^Fp, Gll^Fmw, Gll^Fp, Gs^Vh, Re^Gvs, Gg, Hh, Hh, Gll^Fp, Gll^Fp, Gll^Fmw, Gll^Fmf, Gll^Fmf
Ha, Ha, Mm, Mm, Mm, Hh, Gll^Fp, Gll^Fp, Gll^Fp, Gll^Fp, Gll^Fp, Gs, Re, Gll^Fp, Hh, Gll^Fp, Re, Gll^Fp, Gll^Fmf, Ai, Ww, Ww, Ai, Ww, Ww, Ww, Ww, Ww, Ww, Ww, Ww, Re, Re, Gll^Fmf, Gll^Fmf, Gll^Fmf, Gll^Fmf, Gll^Fp, Gll^Fp, Gll^Fp, Hh, Hh, Hh, Hh^Fp, Hh, Hh, Hh, Hh
Mm, Mm, Mm, Mm, Mm, Mm, Hh, Hh^Fp, Mm, Mm, Mm, Mm, Gll^Fp, Re, Re, Re, Gll^Fp, Gs^Vh, Ai, Ai, Ai, Ai, Ww, Ww, Ww, Ww, Ww, Ww, Ww, Ww, Ww, Ww, Re, Gll^Fp, Gll^Fmf, Gll^Fmf, Gll^Fp, Gll^Fmf, Gll^Fp, Mm, Mm, Mm, Mm, Mm, Mm, Mm, Mm, Mm
Mm, Mm, Mm, Mm, Mm, Mm, Mm, Mm, Hh, Hh, Hh, Gll^Fp, Gll^Fmw, Gll^Fp, Gg^Es, Gll^Fp, Gll^Fp, Gll^Fp, Gg, Ai, Gll^Fp, Ai, Ai, Ww, Ww, Ww, Ww, Ww, Ww, Ww, Ww, Ww, Ch, Ch, Ch, Gll^Fmw, Gll^Fp, Gll^Fp, Gll^Fmf, Gll^Fp, Gll^Fp, Gll^Fp, Gs^Vh, Hh, Gg, Mm, Mm, Mm
Mm, Mm, Mm, Mm, Mm, Mm, Mm, Mm, Mm, Mm, Mm, Gll^Fmf, Gll^Fp, Gll^Fp, Gg, Gg, Gg, Gg, Gll^Fp, Gll^Fp, Gg^Fet, Gll^Fp, Gll^Fmf, Gll^Fmf, Ww, Ww, Ww, Ww, Ww, Ww, Ai, Ai, Ch, 3 Kh, Ch, Gll^Fmf, Gg^Es, Gs^Vh, Gll^Fmf, Gll^Fmf, Gll^Fp, Gll^Fp, Re^Gvs, Gg, Gg, Gs^Vh, Hh, Hh
Mm, Mm, Mm, Mm, Mm, Ha^Vhha, Mm, Mm, Hhd, Hhd, Gll^Fp, Gll^Fmf, Gll^Fp, Gs^Vh, Re^Gvs, Re^Gvs, Gll^Fp, Gg, Gll^Fmf, Gll^Fp, Gll^Fmw, Gll^Fp, Gll^Fmf, Gll^Fp, Gll^Fp, Gll^Fp, Gll^Fmf, Wwt, Ai, Ww, Ai, Ai, Ch, Ch, Ch, Gg, Gg, Re^Gvs, Re^Gvs, Gg, Gll^Fp, Re^Gvs, Re^Gvs, Re^Gvs, Re^Gvs, Gg, Gg, Hh
Mm, Mm, Mm, Mm, Mm, Mm, Mm, Mm, Ha, Ha, Gll^Fp, Gll^Fp, Gll^Fp, Gll^Fmf, Gll^Fp, Gs^Fmw, Gg, Gll^Fp, Gll^Fmf, Gll^Fmf, Gg, Gll^Fp, Gs^Fp, Gll^Fmf, Gs^Fp, Gll^Fp, Gs^Fp, Gll^Fp, Gll^Fp, Gll^Fp, Gll^Fp, Ai, Hh, Re, Hh, Gg, Gll^Fp, Re^Gvs, Re^Gvs, Hh, Hh, Gll^Fp, Gll^Fp, Gll^Fp, Gll^Fp, Hhd, Hhd, Hhd
Mm, Mm, Mm, Mm, Mm, Mm, Ha, Ha, Mm, Mm, Mm, Mm, Mm, Gg, Gg, Gg, Hh, Mm, Mm, Hh, Gg, Gll^Fp, Re^Gvs, Gs^Vc, Re^Gvs, Gll^Fp, Gg, Gll^Fp, Gg, Gll^Fp, Gll^Fp, Gll^Fp, Hh, Re, Gg, Gg, Gll^Fmf, Gll^Fmf, Gll^Fmw, Hh, Gll^Fp, Mm, Mm, Mm, Mm, Mm, Mm, Mm
Ha, Mm, Ha, Ha, Ha, Ha, Mm, Mm, Mm, Mm, Hh, Mm, Gg, Gg, Gg, Gg, Gll^Fmf, Gll^Fp, Gll^Fp, Gg, Gg, Re^Gvs, Gg, Re^Gvs, Gg, Gg, Gg, Gg, Gg, Gg, Gg, Gg, Re, Re, Gll^Fp, Gll^Fmf, Gll^Fp, Gll^Fp, Gll^Fp, Gll^Fp, Gg^Fet, Gll^Fp, Hh, Mm, Mm, Mm, Mm, Mm
Mm, Ha, Mm, Mm, Mm, Mm, Hh, Mm, Mm, Hh^Fp, Gll^Fmf, Gll^Fp, Gll^Fp, Gll^Fp, Gll^Fp, Gll^Fmf, Gll^Fp, Gll^Fp, Gll^Fmf, Gg, Gg, Gg, Re, Re, Re, Re, Re, Re, Re, Re, Re, Re, Gg, Gg, Gll^Fp, Gll^Fmf, Re^Gvs, Gs^Vh, Gll^Fp, Gll^Fmf, Gll^Fp, Gll^Fp, Gll^Fp, Hh, Mm, Mm, Mm, Mm
Mm, Mm, Mm, Mm, Mm, Hh, Hh^Vhh, Gll^Fp, Gll^Fp, Gll^Fp, Gll^Fmf, Gll^Fp, Re^Gvs, Gs^Vh, Gll^Fp, Gg, Gg, Gg, Gg, Gg, Re^Gvs, Re, Gll^Fmf, Gll^Fmf, Gll^Fp, Gg, Gg, Gg, Gg, Gg, Gg, Gg, Gs^Vh, Gll^Fp, Gs, Re^Gvs, Gg, Gg, Gll^Fp, Gg, Re^Gvs, Re^Gvs, Gll^Fp, Gll^Fp, Gll^Fp, Hhd, Hhd, Hhd
Mm, Mm, Mm, Mm, Hhd, Hhd, Gll^Fp, Gll^Fp, Gg^Fet, Gll^Fp, Gll^Fp, Re^Gvs, Gg, Gg, Re^Gvs, Gg, Gll^Fp, Gll^Fp, Gll^Fp, Gll^Fp, Re^Gvs, Re, Gll^Fp, Gll^Fmf, Gll^Fp, Hh, Hh, Gll^Fp, Gg, Gg, Gll^Fp, Re^Gvs, Gll^Fp, Gg, Gg, Gs, Gg, Gll^Fp, Gll^Fp, Gg, Gg, Gll^Fp, Gg, Gs^Vh, Gll^Fp, Gll^Fp, Gll^Fp, Hhd
Mm, Mm, Mm, Hhd, Mm, Gll^Fp, Mm, Gll^Fp, Gll^Fp, Gll^Fp, Gll^Fmw, Gg, Gg, Re^Gvs, Gll^Fp, Gll^Fp, Gll^Fmw, Gll^Fmf, Gll^Fp, Re^Gvs, Re, Re, Re^Gvs, Gll^Fp, Gll^Fp, Gll^Fp, Mm, Gll^Fp, Gll^Fp, Gll^Fmf, Gll^Fp, Gll^Fmf, Gll^Fp, Gll^Fp, Gg^Es, Gll^Fmf, Gg, Gll^Fp, Gll^Fp, Mm, Mm, Gg, Gs, Gll^Fp, Mm, Mm, Mm, Hhd
Mm, Mm, Mm, Mm, Mm, Mm, Mm, Mm, Ha, Gll^Fp, Gll^Fp, Gll^Fp, Aa^Vha, Gg, Gll^Fp, Gll^Fp, Mm, Hh, Gg, Gg, Re, Gg, Gg, Gs^Vh, Re^Gvs, Gll^Fp, Gll^Fp, Gll^Fp, Gg, Gg, Gll^Fp, Gll^Fmf, Hh, Gg, Gll^Fp, Gg, Re^Gvs, Gs^Vh, Gll^Fp, Gll^Fp, Gll^Fp, Gg, Gs, Hh, Ha^Vhha, Mm, Mm, Mm
Mm, Mm, Mm, Mm, Ha, Ha, Ha, Ha, Hh, Gll^Fp, Gll^Fmw, Gll^Fp, Gll^Fp, Aa, Gll^Fmw, Gll^Fp, Hh, Gll^Fp, Gll^Fp, Gg, Gg, Re, Gg, Gg, Gg, Gll^Fp, Gll^Fp, Gll^Fp, Gll^Fmf, Gll^Fmf, Gll^Fp, Gll^Fmw, Gll^Fp, Mm, Mm, Gll^Fp, Re^Gvs, Re^Gvs, Hh, Mm, Mm, Hh, Mm, Gs, Gg, Mm, Mm, Mm
Mm, Mm, Mm, Mm, Ha, Mm, Mm, Mm, Mm, Mm, Gll^Fp, Gll^Fp, Mm, Gll^Fp, Gll^Fp, Gll^Fp, Gll^Fp, Gll^Fp, Ce, Ce, 1 Ce, Re, 2 Ce, Ce, Ce, Gll^Fp, Gll^Fp, Gll^Fp, Gll^Fp, Gll^Fp, Gll^Fp, Gll^Fmw, Gll^Fp, Gll^Fp, Gll^Fp, Hh, Gg, Hh, Mm, Hh, Mm, Mm, Mm, Gg, Hh, Hh, Mm, Mm
Mm, Mm, Ha, Ha, Mm, Mm, Mm, Mm, Hh, Gll^Fp, Gll^Fp, Mm, Gll^Fp, Gll^Fmw, Gll^Fp, Gll^Fmw, Gll^Fp, Gll^Fp, Gg, Ke, Gg, Re, Gg, Ke, Gg, Gll^Fp, Gll^Fp, Gg^Fet, Gll^Fp, Gll^Fp, Gg^Ve, Gll^Fp, Gll^Fp, Gll^Fmw, Hhd, Hh, Mm, Mm, Mm, Mm, Mm, Mm, Mm, Hh, Cea, Cea, Cea, Mm
Ha, Ha, Mm, Mm, Mm, Mm, Mm, Mm, Mm, Hh, Mm, Gll^Fp, Mm, Gll^Fp, Hhd, Mm, Mm, Hhd, Gll^Fp, Gg, Gll^Fp, Re, Gg, Gll^Fp, Gg, Gll^Fp, Gll^Fp, Gll^Fp, Gll^Fmw, Gll^Fp, Gll^Fp, Gll^Fp, Gll^Fp, Gll^Fp, Hhd, Mm, Mm, Mm, Mm, Ha^Vhha, Mm, Mm, Mm, Mm, Cea, 6 Kea, Cea, Mm
Mm, Mm, Mm, Mm, Mm, Mm, Mm, Mm, Mm, Mm, Mm, Mm, Mm, Mm, Mm, Mm, Mm, Hhd, Hhd, Gll^Fp, Gll^Fp, Re, Gg, Gg, Gll^Fp, Gll^Fp, Gll^Fp, Gll^Fmw, Gll^Fp, Gll^Fp, Gll^Fp, Gll^Fp, Hhd, Hhd, Hhd, Mm, Mm, Mm, Mm, Mm, Mm, Mm, Mm, Mm, Cea, Cea, Cea, Mm
