Mm, Mm, Mm, Re, Re, Gg, Hh, Mm, Mm, Mm, Mm, Mm, Mm, Mm, Mm, Mm, Mm, Mm, Mm, Mm, Mm, Mm, Ha, Mm, Mm, Mm, Mm, Mm, Mm, Mm, Mm, Mm, Mm, Mm, Mm, Mm, Mm, Mm, Mm, Mm, Mm, Mm, Mm, Mm, Cea, Cea, Cea, Mm
Mm, Mm, Mm, Mm, Re, Gg, Hh, Hh, Hh, Mm, Mm, Mm, Mm, Mm, Mm, Mm, Mm, Mm, Mm, Mm, Mm, Mm, Ha, Mm, Mm, Mm, Mm, Mm, Mm, Mm, Ha, Ha, Ha, Mm, Mm, Mm, Mm, Mm, Mm, Mm, Mm, Mm, Mm, Mm, Cea, 5 Kea, Cea, Mm
Mm, Mm, Mm, Gs^Vh, Re, Gg, Gg, Gg, Mm, Mm, Mm, Hh, Hh, Mm, Mm, Mm, Mm, Mm, Mm, Mm, Mm, Ha, Mm, Mm, Mm, Mm, Mm, Ha, Mm, Ha, Wwt, Wwt, Ha, Ha, Ha, Mm, Mm, Mm, Mm, Hh^Vhh, Mm, Mm, Mm, Mm, Cea, Cea, Cea, Mm
Mm, Mm, Mm, Re^Gvs, Mm, Re, Ce, Ce, Ce, Mm, Gg, Mm, Hh, Hh, Mm, Mm, Mm, Mm, Mm, Mm, Ha, Ha, Mm, Hh^Vhh, Mm, Mm, Mm, Ha, Wwt, Wwt, Wwt, Wwt, Wwt, Wwt, Ha, Mm, Ha, Mm, Ha, Mm, Mm, Mm, Gg, Mm, Mm, Mm, Mm, Mm
Mm, Mm, Mm, Mm, Mm, Mm, Ce, 4 Ke, Ce, Ce, Gg, Mm, Re^Gvs, Gs^Vh, Mm, Mm, Mm, Mm, Gll^Fp, Mm, Mm, Mm, Mm, Mm, Mm, Mm, Ha, Ha, Wwt, Wwt, Wot, Wot, Wwt, Wwt, Ai, Ha, Mm, Ha, Mm, Mm, Hh, Hh, Gg, Gg, Mm, Mm, Mm, Mm
Mm, Mm, Mm, Mm, Mm, Mm, Gg, Ce, Re, Gg, Gg, Re^Gvs, Mm, Mm, Gll^Fp, Mm, Gg^Ve, Gll^Fp, Gll^Fp, Gll^Fp, Mm, Mm, Mm, Mm, Mm, Mm, Ha, Ai, Wwt, Wwt, Wot, Wot, Wot, Wwt, Wwt, Ha, Mm, Mm, Mm, Mm, Hh, Re^Gvs, Re^Gvs, Gg, Gll^Fp, Mm, Hh, Mm
Mm, Mm, Mm, Mm, Mm, Mm, Gg, Ce, Gg, Re, Mm, Mm, Mm, Mm, Mm, Gll^Fp, Gll^Fp, Gll^Fp, Gll^Fp, Mm, Mm, Mm, Mm, Mm, Mm, Ha, Ha, Ai, Wwt, Wwt, Wwt, Wot, Wwt, Wwt, Ww, Mm, Mm, Mm, Mm, Mm, Mm, Mm, Mm, Gs^Vh, Gll^Fp, Hh, Mm, Mm
Mm, Mm, Mm, Mm, Hh^Vhh, Mm, Mm, Gg, Gg, Re, Re, Mm, Hh, Hh, Mm, Mm, Gll^Fp, Gll^Fp, Gg, Gs^Vh, Re^Gvs, Mm, Mm, Mm, Ha, Ha, Gll^Fp, Gll^Fp, Gll^Fp, Ww, Ww, Wwt, Wwt, Wwt, Ww, Ww, Ai, Gg, Re^Gvs, Gs^Vh, Gg, Gg, Mm, Gg, Gll^Fp, Hh, Mm, Mm
Mm, Mm, Mm, Mm, Mm, Hh, Hh, Re^Gvs, Re^Gvs, Gll^Fp, Re, Gll^Fp, Hh, Mm, Mm, Mm, Gll^Fp, Gll^Fp, Gg, Re^Gvs, Gll^Fp, Mm, Mm, Mm, Mm, Mm, Gll^Fp, Gll^Fp, Gll^Fp, Ww, Ww, Ww, Ww, Ww, Ww, Ww, Ai, Gg, Gg, Re^Gvs, Gg, Gll^Fp, Gg, Gg, Gll^Fp, Mm, Mm, Hh
Mm, Mm, Mm, Mm, Mm, Hh, Hh, Gs^Vh, Gll^Fp, Gll^Fp, Re, Gll^Fp, Gll^Fp, Gll^Fp, Mm, Mm, Gll^Fp, Gll^Fp, Re, Re, Re, Re, Re, Re, Re, Gs^Vc, Re, Gll^Fp, Gll^Fp, Gll^Fp, Ww, Ww, Ww, Ww, Ww, Ai, Ai, Ai, Ai, Gll^Fp, Gll^Fp, Gg, Gg, Hh, Gll^Fp, Hh, Hh, Hh
Mm, Mm, Ha, Ha, Ha, Mm, Ha, Ha, Aa, Gll^Fp, Re, Gll^Fp, Gll^Fp, Mm, Mm, Mm, Hh, Re, Gll^Fp, Gll^Fp, Gll^Fp, Gll^Fp, Gll^Fp, Gll^Fp, Gll^Fp, Re, Gll^Fp, Re, Re, Gll^Fp, Ww, Ww, Gll^Fp, Ww, Ai, Ai, Gll^Fp, Ai, Gll^Fp, Gll^Fp, Re^Gvs, Gg, Gll^Fp, Gg, Gg^Ve, Hh, Hh, Gll^Fp
Mm, Ha, Mm, Mm, Mm, Ha, Gll^Fp, Gll^Fp, Gll^Fp, Gs^Vc, Re^Gvs, Re, Re, Gll^Fp, Mm, Mm, Re, Re, Gll^Fp, Gs^Fmw, Ww, Gll^Fp, Ww, Gll^Fp, Gll^Fp, Gll^Fp, Gll^Fp, Gll^Fp, Gll^Fp, Ww^Bw\, Re, Gll^Fp, Gll^Fp, Gll^Fp, Gll^Fp, Gll^Fp, Gll^Fp, Gll^Fp, Gs^Vh, Re^Gvs, Gg, Hh, Hh, Gll^Fp, Gll^Fp, Gll^Fp, Gll^Fp, Gll^Fp
Ha, Ha, Mm, Mm, Mm, Hh, Gll^Fp, Gll^Fp, Gll^Fp, Gll^Fp, Gll^Fp, Gg, Re, Gll^Fp, Hh, Gll^Fp, Re, Gll^Fp, Gll^Fp, Ai, Ww, Ww, Ai, Ww, Ww, Ww, Ww, Ww, Ww, Ww, Ww, Re, Re, Gll^Fp, Gll^Fp, Gll^Fp, Gll^Fp, Gll^Fp, Gll^Fp, Gll^Fp, Hh, Hh, Hh, Hh, Hh, Hh, Hh, Hh
Mm, Mm, Mm, Mm, Mm, Mm, Hh, Hh, Mm, Mm, Mm, Mm, Gll^Fp, Re, Re, Re, Gll^Fp, Gs^Vh, Ai, Ai, Ai, Ai, Ww, Ww, Ww, Ww, Ww, Ww, Ww, Ww, Ww, Ww, Re, Gll^Fp, Gll^Fp, Gll^Fp, Gll^Fp, Gll^Fp, Gll^Fp, Mm, Mm, Mm, Mm, Mm, Mm, Mm, Mm, Mm
Mm, Mm, Mm, Mm, Mm, Mm, Mm, Mm, Hh, Hh, Hh, Gll^Fp, Gll^Fp, Gll^Fp, Gg, Gll^Fp, Gll^Fp, Gll^Fp, Gg, Ai, Gll^Fp, Ai, Ai, Ww, Ww, Ww, Ww, Ww, Ww, Ww, Ww, Ww, Ch, Ch, Ch, Gll^Fp, Gll^Fp, Gll^Fp, Gll^Fp, Gll^Fp, Gll^Fp, Gll^Fp, Gs^Vh, Hh, Gg, Mm, Mm, Mm
Mm, Mm, Mm, Mm, Mm, Mm, Mm, Mm, Mm, Mm, Mm, Gll^Fp, Gll^Fp, Gll^Fp, Gg, Gg, Gg, Gg, Gll^Fp, Gll^Fp, Gll^Fp, Gll^Fp, Gll^Fp, Gll^Fp, Ww, Ww, Ww, Ww, Ww, Ww, Ai, Ai, Ch, 3 Kh, Ch, Gll^Fp, Gg, Gs^Vh, Gll^Fp, Gll^Fp, Gll^Fp, Gll^Fp, Gg^Gvs, Gg, Gg, Gs^Vh, Hh, Hh
Mm, Mm, Mm, Mm, Mm, Hh^Vhh, Mm, Mm, Hh, Hh, Gll^Fp, Gll^Fp, Gll^Fp, Gs^Vh, Re^Gvs, Re^Gvs, Gll^Fp, Gg, Gll^Fp, Gll^Fp, Gll^Fp, Gll^Fp, Gll^Fp, Gll^Fp, Gll^Fp, Gll^Fp, Gll^Fp, Wwt, Ai, Ww, Ai, Ai, Ch, Ch, Ch, Gg, Gg, Gg^Gvs, Gg^Gvs, Gg, Gll^Fp, Gg^Gvs, Gg^Gvs, Gg^Gvs, Gg^Gvs, Gg, Gg, Hh
Mm, Mm, Mm, Mm, Mm, Mm, Mm, Mm, Ha, Ha, Gll^Fp, Gll^Fp, Gll^Fp, Gll^Fp, Gll^Fp, Gs^Fmw, Gg, Gll^Fp, Gll^Fp, Gll^Fp, Gg, Gll^Fp, Gs^Fp, Gll^Fp, Gs^Fp, Gll^Fp, Gs^Fp, Gll^Fp, Gll^Fp, Gll^Fp, Gll^Fp, Ai, Hh, Re, Hh, Gg, Gll^Fp, Gg^Gvs, Gg^Gvs, Hh, Hh, Gll^Fp, Gll^Fp, Gll^Fp, Gll^Fp, Hh, Hh, Hh
Mm, Mm, Mm, Mm, Mm, Mm, Ha, Ha, Mm, Mm, Mm, Mm, Mm, Gg, Gg, Gg, Hh, Mm, Mm, Hh, Gg, Gll^Fp, Gg, Gs^Vc, Re^Gvs, Gll^Fp, Gg, Gll^Fp, Gg, Gll^Fp, Gll^Fp, Gll^Fp, Hh, Re, Gg, Gg, Gll^Fp, Gll^Fp, Gll^Fp, Hh, Gll^Fp, Mm, Mm, Mm, Mm, Mm, Mm, Mm
Ha, Mm, Ha, Ha, Ha, Ha, Mm, Mm, Mm, Mm, Hh, Mm, Gg, Gg, Gg, Gg, Gll^Fp, Gll^Fp, Gll^Fp, Gg, Gg, Gg, Gg, Re^Gvs, Gg, Gg, Re, Gg, Gg, Gg, Gg, Gg, Re, Re, Gll^Fp, Gll^Fp, Gll^Fp, Gll^Fp, Gll^Fp, Gll^Fp, Gll^Fp, Gll^Fp, Hh, Mm, Mm, Mm, Mm, Mm
Mm, Ha, Mm, Mm, Mm, Mm, Hh, Mm, Mm, Hh, Gll^Fp, Gll^Fp, Gll^Fp, Gll^Fp, Gll^Fp, Gll^Fp, Gll^Fp, Gll^Fp, Gll^Fp, Gg, Gg, Gg, Re, Re, Re, Re, Gg, Re, Re, Gg, Re, Re, Gg, Gg, Gll^Fp, Gll^Fp, Re^Gvs, Gs^Vh, Gll^Fp, Gll^Fp, Gll^Fp, Gll^Fp, Gll^Fp, Hh, Mm, Mm, Mm, Mm
Mm, Mm, Mm, Mm, Mm, Hh, Hh^Vhh, Gll^Fp, Gll^Fp, Gll^Fp, Gll^Fp, Gll^Fp, Re^Gvs, Gs^Vh, Gll^Fp, Gg, Gg, Gg, Gg, Gg, Gg, Re, Gll^Fp, Gll^Fp, Gll^Fp, Gg, Gg, Gg, Gg, Re, Gg, Gg, Gs^Vh, Gll^Fp, Gg, Re^Gvs, Gg, Gg, Gll^Fp, Gg, Re^Gvs, Re^Gvs, Gll^Fp, Gll^Fp, Gll^Fp, Hh, Hh, Hh
Mm, Mm, Mm, Mm, Hh, Hh, Gll^Fp, Gll^Fp, Gll^Fp, Gll^Fp, Gll^Fp, Re^Gvs, Gg, Gg, Re^Gvs, Gg, Gll^Fp, Gll^Fp, Gll^Fp, Gll^Fp, Re^Gvs, Re, Gll^Fp, Gll^Fp, Gll^Fp, Hh, Hh, Gll^Fp, Gg, Gg, Gll^Fp, Re^Gvs, Gll^Fp, Gg, Gg, Gg, Gg, Gll^Fp, Gll^Fp, Gg, Gg, Gll^Fp, Gg, Gs^Vh, Gll^Fp, Gll^Fp, Gll^Fp, Hh
Mm, Mm, Mm, Hh, Mm, Gll^Fp, Mm, Gll^Fp, Gll^Fp, Gll^Fp, Gll^Fp, Gg, Gg, Re^Gvs, Gll^Fp, Gll^Fp, Gll^Fp, Gll^Fp, Gll^Fp, Re^Gvs, Gg, Re, Gg, Gll^Fp, Gll^Fp, Gll^Fp, Mm, Gll^Fp, Gll^Fp, Gll^Fp, Gll^Fp, Gll^Fp, Gll^Fp, Gll^Fp, Gg, Gll^Fp, Gg, Gll^Fp, Gll^Fp, Mm, Mm, Gg, Gg, Gll^Fp, Mm, Mm, Mm, Hh
Mm, Mm, Mm, Mm, Mm, Mm, Mm, Mm, Ha, Gll^Fp, Gll^Fp, Gll^Fp, Gs^Vh, Gg, Gll^Fp, Gll^Fp, Mm, Hh, Gg, Gg, Gg, Re, Gg, Gs^Vh, Gg, Gll^Fp, Gll^Fp, Gll^Fp, Gg, Gg, Gll^Fp, Gll^Fp, Hh, Gg, Gll^Fp, Gg, Re^Gvs, Gs^Vh, Gll^Fp, Gll^Fp, Gll^Fp, Gg, Gg, Hh, Hh^Vhh, Mm, Mm, Mm
Mm, Mm, Mm, Mm, Ha, Ha, Ha, Ha, Hh, Gll^Fp, Gll^Fp, Gll^Fp, Gll^Fp, Gg, Gll^Fp, Gll^Fp, Hh, Gll^Fp, Gll^Fp, Gg, Gg, Re, Gg, Gg, Gg, Gll^Fp, Gll^Fp, Gll^Fp, Gll^Fp, Gll^Fp, Gll^Fp, Gll^Fp, Gll^Fp, Mm, Mm, Gll^Fp, Re^Gvs, Re^Gvs, Hh, Mm, Mm, Hh, Mm, Gg, Gg, Mm, Mm, Mm
Mm, Mm, Mm, Mm, Ha, Mm, Mm, Mm, Mm, Mm, Gll^Fp, Gll^Fp, Mm, Gll^Fp, Gll^Fp, Gll^Fp, Gll^Fp, Gll^Fp, Ce, Ce, 1 Ce, Re, 2 Ce, Ce, Ce, Gll^Fp, Gll^Fp, Gll^Fp, Gll^Fp, Gll^Fp, Gll^Fp, Gll^Fp, Gll^Fp, Gll^Fp, Gll^Fp, Hh, Gg, Hh, Mm, Hh, Mm, Mm, Mm, Gg, Mm, Mm, Mm, Mm
Mm, Mm, Ha, Ha, Mm, Mm, Mm, Mm, Hh, Gll^Fp, Gll^Fp, Mm, Gll^Fp, Gll^Fp, Gll^Fp, Gll^Fp, Gll^Fp, Gll^Fp, Gg, Ke, Gg, Re, Gg, Ke, Gg, Gll^Fp, Gll^Fp, Gll^Fp, Gll^Fp, Gll^Fp, Gg^Ve, Gll^Fp, Gll^Fp, Gll^Fp, Hh, Hh, Mm, Mm, Mm, Mm, Mm, Mm, Mm, Mm, Cea, Cea, Cea, Mm
Ha, Ha, Mm, Mm, Mm, Mm, Mm, Mm, Mm, Hh, Mm, Gll^Fp, Mm, Gll^Fp, Hh, Mm, Mm, Hh, Gg, Gg, Gg, Re, Gg, Gg, Gg, Gll^Fp, Gll^Fp, Gll^Fp, Gll^Fp, Gll^Fp, Gll^Fp, Gll^Fp, Gll^Fp, Gll^Fp, Hh, Mm, Mm, Mm, Mm, Hh^Vhh, Mm, Mm, Mm, Mm, Cea, 6 Kea, Cea, Mm
Mm, Mm, Mm, Mm, Mm, Mm, Mm, Mm, Mm, Mm, Mm, Mm, Mm, Mm, Mm, Mm, Mm, Hh, Hh, Gg, Gll^Fp, Re, Gg, Gg, Gll^Fp, Gll^Fp, Gll^Fp, Gll^Fp, Gll^Fp, Gll^Fp, Gll^Fp, Gll^Fp, Hh, Hh, Hh, Mm, Mm, Mm, Mm, Mm, Mm, Mm, Mm, Mm, Cea, Cea, Cea, Mm
