Mm, Mm, Mm, Mm, Ha, Ha, Mm, Mm, Mm, Mm, Mm, Mm, Mm, Mm, Mm, Mm, Mm, Mm, Mm, Mm, Mm, Mm, Ha, Mm, Mm, Mm, Mm, Mm, Mm, Mm, Mm, Mm, Mm, Mm, Mm, Mm, Mm, Mm, Mm, Mm, Mm, Mm, Mm, Mm, Cea, Cea, Cea, Mm
Mm, Mm, Mm, Mm, Ha, Ha, Mm, Mm, Mm, Mm, Mm, Mm, Mm, Mm, Mm, Mm, Mm, Mm, Mm, Mm, Mm, Mm, Ha, Mm, Mm, Mm, Mm, Mm, Mm, Mm, Ha, Ha, Ha, Mm, Mm, Mm, Mm, Mm, Mm^Vhh, Mm, Mm, Mm, Mm, Mm, Cea, 5 Kea, Cea, Mm
Mm, Mm, Mm, Mm, Mm, Ha, Ha, Ha, Ha, Ha, Ha, Mm, Mm, Mm, Mm^Vhh, Mm, Mm, Mm, Mm, Mm, Mm, Ha, Mm, Mm, Mm^Vhh, Mm, Mm, Ha, Mm, Ha, Wwt, Wwt, Ha, Ha, Ha, Mm, Mm, Mm, Mm, Mm, Mm, Mm, Mm, Mm, Cea, Cea, Cea, Mm
Mm, Mm, Mm, Mm, Mm, Mm, Ce, Ce, Ce, Hhd, Hhd, Ha, Mm, Mm, Mm, Mm, Mm, Mm, Mm, Mm, Ha, Ha, Mm, Mm, Mm, Mm, Mm, Ha, Wwt, Wwt, Wwt, Wwt, Wwt, Wwt, Ha, Mm, Ha, Mm, Ha, Mm, Mm, Mm, Mm, Mm, Mm, Mm, Mm, Mm
Mm, Mm, Mm, Mm, Mm, Mm, Ce, 4 Ke, Ce, Ce, Hhd, Ha, Mm, Mm, Mm, Mm, Mm, Mm, Hhd, Mm, Mm, Mm, Mm, Mm, Mm, Mm, Ha, Ha, Wwt, Wwt, Wot, Wot, Wwt, Wwt, Ai^Es, Ha, Mm, Ha, Mm, Mm, Mm, Mm, Mm, Mm, Mm, Mm, Mm, Mm
Mm, Mm, Mm^Vhh, Mm, Mm, Mm, Mm, Ce, Hhd, Hhd, Hhd, Mm, Mm, Mm, Hhd, Mm, Hhd, Hhd, Gs^Fp, Gs^Fp, Mm, Mm, Mm, Mm, Mm, Mm, Ha, Ai, Wwt, Wwt, Wot, Wot, Wot, Wwt, Wwt, Ha, Mm, Mm, Mm, Mm, Mm, Mm, Mm, Mm, Hh^Vhh, Mm, Hhd, Mm
Mm, Mm, Mm, Mm, Mm, Mm, Mm, Ce, Hhd, Hhd, Hhd, Hh^Vhh, Mm, Mm, Mm, Hhd, Hhd, Hh^Fmw, Gs^Fp, Mm, Mm, Mm, Mm, Mm, Mm, Ha, Ha, Ai, Wwt, Wwt, Wwt, Wot, Wwt, Wwt, Wwt, Mm, Mm, Mm, Mm, Mm, Mm, Mm, Mm, Mm, Hh, Hhd, Mm, Mm
Mm, Mm, Mm, Mm, Mm, Mm, Mm, Mm, Hh, Hh, Aa, Mm, Mm, Mm, Mm, Mm, Hh^Fp, Gg^Ve, Gs^Fmw, Gs^Fp, Hh^Fp, Mm, Mm, Mm, Ha, Ha, Hhd^Fp, Gd^Fp, Gs^Fp, Wwt, Wwt, Wwt, Wwt, Wwt, Wwt, Gs^Fp, Gs^Fp, Gs^Fp, Gs^Fp, Gs^Fp, Gs^Em, Gs^Fp, Mm, Hh, Hhd, Hhd, Mm, Mm
Mm, Mm, Mm, Mm, Mm, Mm, Mm, Hh, Hh, Gs^Vh, Aa, Re^Gvs, Mm, Mm, Mm, Mm, Hh^Fp, Gs^Fp, Gs^Fmf, Gs^Fp, Hh, Mm, Mm, Mm, Mm, Mm, Hh^Fp, Gs^Fp, Gs^Fmf, Gs^Fp, Gs^Fp, Wwt, Ai, Ai, Gs^Fp, Gs^Fp, Gs^Fmw, Gs^Fp, Gg^Fet, Gs^Fp, Gs^Fp, Gs^Fp, Gs^Fp, Gs^Fp, Hh^Fp, Mm, Mm, Hh
Mm, Mm, Mm, Mm, Mm, Mm, Hh, Hh, Re^Gvs, Gg, Gg, Re^Gvs, Hh, Hh, Mm, Mm, Gs^Fp, Hh^Fp, Gs^Fmf, Hh^Fp, Gs^Fp, Hh, Gs^Fp, Gs^Fp, Gs^Fp, Hh^Fp, Gs^Fp, Hh^Fp, Gs^Fmw, Gs^Fmw, Gs^Fmw, Gs^Fp, Gs^Fp, Gs^Fp, Gs^Fmw, Gs^Fmw, Gs^Fp, Gs^Fp, Gs^Fp, Gs^Fp, Hh, Gs^Fp, Gg^Ve, Gs^Fmw, Gs^Fp, Gs^Fp, Gs^Fp, Gd^Fp
Mm, Mm, Ha, Ha, Ha, Mm, Ha, Ha, Aa, Re^Gvs, Gg, Gs^Vh, Hh, Mm, Mm, Mm, Hh, Gs^Fp, Gs^Fp, Gs^Fp, Gs^Fmf, Gs^Fmf, Gs^Fp, Gs^Fp, Gs^Fmf, Gs^Fmw, Gs^Fmf, Gs^Fmw, Gs^Fmw, Gs^Fp, Gs^Fmf, Gs^Fp, Gs^Fp, Gs^Fmw, Gs^Fp, Gs^Fmw, Gs^Fp, Hh, Hh^Fp, Gs^Fmw, Gs^Fmw, Gs^Fmw, Gs^Fp, Gs^Fp, Gs^Fmw, Hhd, Hh^Fp, Gs^Fp
Mm, Ha, Mm, Mm, Mm, Ha, Hhd, Hh, Hh, Hh, Aa, Gg^Es, Gg, Hh, Mm, Mm, Gs^Fp, Hh^Fp, Gs^Fmf, Gs^Fmw, Gs^Fmf, Gs^Fmf, Gg^Ve, Gs^Fp, Gs^Fmf, Gs^Fmf, Gs^Fmf, Gs^Fmf, Gs^Fmf, Gs^Fmf, Gs^Fp, Gs^Fp, Gs^Fp, Hh^Fp, Gs^Fp, Gs^Fp, Gs^Fp, Gs^Fp, Gs^Fp, Gs^Fp, Gs^Fp, Hh, Hh, Gs^Fmw, Gs^Fp, Gs^Fp, Gs^Fp, Gs^Fp
Ha, Ha, Mm, Mm, Mm, Mm, Hhd, Hh^Vhh, Hh, Ha, Ha, Aa, Gg, Gg, Mm, Gs^Vl, Gs^Fp, Gs^Fp, Gs^Fmf, Gs^Fp, Gs^Fp, Wwt, Wwt^Es, Wwt, Wwt, Wwt, Wwt, Wwt, Wwt, Wwt, Wwt^Es, Mm, Mm, Hh, Hh, Hh, Ch, Ch, Ch, Gs^Fp, Hh, Hh, Hh, Hh, Hhd, Hhd, Hhd, Hh
Mm, Mm, Mm, Mm, Mm, Mm, Mm, Mm, Mm, Mm, Mm, Mm, Hh, Gg, Gg, Gg, Gg, Gg^Efm, Gg, Gg, Gg, Gs^Fp, Gg, Wwt, Wwt, Wot, Wot, Wwt, Wot, Wwt, Wwt, Wwt, Wwt, Wwt, Wwt, Wwt, Ch, 3 Kh, Ch, Mm, Mm, Mm, Mm, Mm, Mm, Mm, Mm, Mm
Mm, Mm, Mm, Mm, Mm, Mm, Mm, Mm, Mm, Mm, Mm, Hh, Hh, Gg, Hh, Gg, Hh, Gg, Gg, Gg^Ve, Gs^Fmw, Gs^Fp, Wwt^Es, Wwt, Wwt, Wot, Wot, Wot, Wot, Wot, Wot, Wwt, Wot, Wwt, Wwt, Wwt, Ch, Ch, Ch, Hh^Fms, Hh^Fms, Hh^Fms, Hh^Fms, Hh, Gg^Ve, Mm, Mm, Mm
Mm, Mm, Mm, Mm, Mm, Mm, Mm, Mm, Mm, Mm, Mm, Hh, Hh^Vhh, Hh, Hhd, Hhd, Hh^Fp, Gs^Fp, Gs^Fmf, Gs^Fp, Hh^Fmf, Gs^Fp, Gs^Fmf, Gs^Fp, Wwt, Wwt, Wwt^Es, Wwt, Wwt, Wot, Wot, Wot, Wot, Wot, Wwt, Wwt, Hh^Fms, Rp, Hh, Hh, Hh, Hh^Fp, Hh^Fp, Hh^Fp, Hh^Fp, Hh^Fp, Hh^Fp, Hh^Fp
Mm, Mm, Mm, Mm, Mm, Mm^Vhh, Mm, Mm, Mm, Mm, Hhd, Hhd, Hh, Hh, Gs^Fp, Hh^Fp, Gd^Fetd, Gs^Fmw, Hh^Fp, Gs^Fp, Gs^Fp, Gs^Fmf, Gs^Fmw, Gs^Fmw, Gs^Fmf, Gs^Fmf, Gs^Fmf, Wwt, Wwt, Wwt, Wwt, Wwt, Wwt, Wwt, Wwt, Wwt, Hh^Fms, Rp, Gg, Gg, Gg, Hh, Hh, Hh^Fms, Hh^Fms, Hh, Hh^Fms, Hh
Mm, Mm, Mm, Mm, Mm, Mm, Mm, Mm, Ha, Ha, Hhd, Hhd, Hh, Gs^Fp, Gs^Fp, Gs^Fmw, Gs^Fp, Gs^Fmw, Gs^Fp, Gs^Fp, Hh^Fp, Gs^Fmf, Gs^Fp, Gs^Fmf, Gs^Fp, Gs^Fmf, Gs^Fp, Gg, Gg, Gs^Fp, Wwt, Wwt, Wwt, Wwt, Wwt^Es, Wwt, Gg, Rp, Gg, Gg, Gs^Fp, Hh^Fp, Gs^Fp, Hhd, Hhd, Hh^Fp, Hh^Fms, Hh
Mm, Mm, Mm, Mm, Mm, Mm, Ha, Ha, Mm, Mm, Mm, Mm, Mm, Mm, Mm, Mm, Mm, Mm, Mm, Mm, Gs^Ve, Gg, Gg, Gg, Rp, Rp, Rp, Gg, Rp, Gg, Gg, Gg, Gg, Gg, Gg, Gg, Rp, Rp, Gg, Wwt, Wwt, Mm, Mm, Mm, Mm, Mm, Mm, Mm
Ha, Mm, Ha, Ha, Ha, Ha, Mm, Mm, Mm, Mm, Mm, Mm, Mm, Ha, Hhd, Hhd, Hhd, Hh, Hh, Hh, Re, Re, Rp, Rp, Gg, Gg, Gg^Vh, Rp, Re^Gvs, Rp, Rp, Rp, Rp, Rp, Rp, Rp, Gg, Gg^Vh, Gg, Wwt, Wwt, Ai, Ai, Mm, Mm, Mm, Mm, Mm
Mm, Ha, Mm, Mm, Mm, Mm, Mm, Mm, Mm, Mm, Mm, Hhd, Hhd, Ha, Hh, Hh, Hh, Gg, Re, Re, Gg, Gg, Rp, Gg, Hh, Hh, Hh, Hh, Re^Gvs, Re^Gvs, Hh, Gg, Gg, Gg, Gg, Gg, Hh, Gg, Gg, Gg, Gg, Gg, Gg, Aa, Mm, Mm, Mm, Mm
Mm, Mm, Mm^Vhh, Mm, Mm, Mm, Mm, Mm, Mm, Mm, Mm, Hh, Hh, Hh, Gg, Hh, Gg^Es, Gg, Hh, Hh, Gg, Rp, Gg, Gg, Hh, Hh, Hh, Gg, Hh, Re^Gvs, Hh, Hh, Gs^Vl, Hh, Re^Gvs, Re^Gvs, Hh, Hh, Gs^Fp, Hh, Hhd, Hh, Gg^Es, Aa, Re^Gvs, Hhd, Hhd, Hhd
Mm, Mm, Mm, Mm, Mm, Mm, Mm, Mm, Mm, Hhd, Hhd, Hh, Hh, Gs^Vh, Re, Gg, Gg, Gg, Hh, Hh, Gg, Rp, Gg, Hh, Hh, Mm, Mm, Gg, Hh, Hh, Hh, Hh, Hh, Hh, Gs^Fp, Hh, Hh, Gs^Fp, Hhd, Hh, Hhd, Hhd, Hhd, Gg, Aa^Vha, Re^Gvs, Hhd, Hhd
Mm, Mm, Mm, Mm, Mm, Mm, Mm, Mm, Mm, Hhd, Hhd, Gg, Re^Gvs, Re, Hhd, Hhd, Hhd, Hh, Hh, Hh, Gg, Rp, Gg, Hh, Gg, Hh, Mm, Hh, Gg, Hh, Re^Gvs, Re^Gvs, Hh, Hh, Hh, Hh, Hh^Fms, Hhd, Hhd, Mm, Mm, Mm, Mm, Aa, Mm, Mm, Mm, Hhd
Mm, Mm, Mm, Mm, Mm, Mm, Mm, Mm, Ha, Hh, Hhd, Gg, Re^Gvs, Re^Gvs, Hhd, Hhd, Mm, Mm, Hh^Fp, Hh^Fp, Gg, Rp, Gg, Gg, Hh, Hh, Hh^Fp, Hh, Hhd, Gg, Gg^Em, Hh, Hh, Hh^Fms, Hh^Fp, Hh, Hh^Fms, Hh^Fp, Mm, Hhd, Ha, Mm, Mm, Mm, Mm, Mm, Mm, Mm
Mm, Mm, Mm, Mm, Ha, Ha, Ha, Ha, Mm, Hh, Hh, Hh, Hh, Aa^Vha, Aa, Hhd, Mm, Hh, Hh, Hh^Fp, Ce, Rp, Ce, Hh, Gg, Hh, Hhd, Hhd, Gll^Fms, Gs^Fp, Hh, Gg, Gs^Fp, Mm, Mm, Hh^Fms, Hh^Fp, Hh^Fms, Mm, Mm, Mm, Ha, Mm, Mm, Mm, Mm, Mm, Mm
Mm, Mm, Mm, Mm, Ha, Mm, Mm, Mm, Mm, Mm, Mm, Hh, Mm, Hh, Hh, Hhd, Hh, Hh, Hh, Ce, 1 Ke, Ce, 2 Ke, Ce, Hh, Hh, Hhd, Hhd, Hhd, Hhd, Hh^Fp, Hh, Hhd, Hh, Hh^Fp, Hh, Mm, Mm, Mm, Mm, Mm, Mm, Mm, Mm, Mm, Mm, Mm, Mm
Mm, Mm, Ha, Ha, Mm, Mm, Mm, Mm^Vhh, Mm, Mm, Mm, Mm, Hh, Hh, Hh, Hh, Hh, Hh, Hh, Ce, Ce, Ce, Ce, Ce, Gg, Hh, Hh, Hh^Fp, Hh^Fms, Hh^Fms, Hh^Fp, Hh, Gll^Ve, Hhd, Hhd, Hh^Fp, Mm, Mm, Mm, Mm, Mm^Vhh, Mm, Mm, Mm, Cea, Cea, Cea, Mm
Ha, Ha, Mm, Mm, Mm, Mm, Mm, Mm, Mm, Mm, Mm, Mm, Mm, Mm, Mm, Mm, Mm, Mm, Hh, Hh, Hh, Re, Gg, Gg, Hh, Hh, Hh, Hh^Fp, Hh^Fms, Hh^Fms, Hh^Fp, Hh, Hh^Fp, Hhd, Hh^Fp, Mm, Mm, Mm, Mm, Mm, Mm, Mm, Mm, Mm, Cea, 6 Kea, Cea, Mm
Mm, Mm, Mm, Mm, Mm, Mm, Mm, Mm, Mm, Mm, Mm, Mm, Mm, Mm, Mm, Mm, Mm, Mm, Hhd, Hh, Hh, Re, Gg, Gg, Hh, Hh, Hh^Fp, Hh^Fp, Hh^Fp, Hh^Fms, Hh^Fms, Hh^Fp, Hh, Hh^Fp, Hh, Mm, Mm, Mm, Mm, Mm, Mm, Mm, Mm, Mm, Cea, Cea, Cea, Mm
