Ha, Ha, Ha, Aa, Aa, Aa, Aa, Aa, Aa, Aa, Aa^Fpa, Aa^Fpa, Aa^Fma, Aa^Fpa, Aa^Fma, Aa^Fpa, Aa^Fpa, Aa^Fma, Aa^Fpa, Aa^Fma, Aa^Fpa, Aa, Aa^Fpa, Aa^Fpa, Aa^Fpa, Aa^Fpa, Aa^Fma, Rra, Aa^Fpa, Aa^Fma, Aa^Fma, Aa^Fpa, Aa^Fpa, Gll^Fp, Aa^Fpa, Aa^Fpa, Ww, Ww, Aa^Fpa, Aa^Fma, Aa^Fpa, Aa^Fpa, Aa^Fpa, Aa^Fpa, Aa^Fpa, Aa^Fpa, Ha, Ha, Ha, Ms, Ms, Ms, Ms, Ha, Ha, Hh, Rra, Rra, Ha, Ha, Ha
Ha, Ha, Ha, Ha, Ha, Aa, Aa, Aa, Aa, Aa, Aa, Aa^Fpa, Aa^Fma, Aa^Fma, Aa^Fpa, Aa^Fma, Aa^Fpa, Aa^Fpa, Aa^Fpa, Aa^Fpa, Aa^Fpa, Aa^Fpa, Aa^Fpa, Aa, Aa, Aa^Fpa, Rra, Rra, Aa^Fpa, Aa, Aa, Aa^Fpa, Aa, Aa^Fpa, Aa^Fpa, Aa^Fpa, Ww, Aa^Fpa, Aa^Fpa, Aa^Fpa, Aa^Fma, Aa^Fpa, Aa^Fpa, Aa^Fma, Aa^Fpa, Ha, Ha, Ha^Fpa, Ms, Ms, Ms, Ms, Ms, Ha, Ha, Ha, Rra, Ha, Ha, Ms, Ms
Re, Ha, Ha, Ha, Ha, Aa, Aa, Aa, Ha, Aa, Aa, Aa, Aa^Fpa, Aa^Fma, Aa^Fpa, Aa^Feta, Aa^Fpa, Aa^Fpa, Aa^Fpa, Aa^Fpa, Aa, Aa^Fma, Aa^Fma, Aa, Rra, Rra, Aa^Fpa, Aa^Fma, Aa, Aa, Aa^Fpa, Aa^Feta, Aa^Fma, Aa^Fpa, Aa^Fma, Aa^Fpa, Ww, Aa^Fma, Aa^Fpa, Aa^Fpa, Aa^Fpa, Aa^Vea, Aa^Fma, Aa^Fpa, Aa^Fpa, Ha^Fpa, Ha^Fpa, Ms, Ha, Ms, Ha, Ms, Ha^Fpa, Ha, Ha, Rra, Ha, Ha, Ms, Ms, Ms
Ha, Re, Ha, Ha, Aa, Ha, Aa, Aa, Aa, Ha, Aa, Aa, Aa, Aa^Fpa, Aa^Fpa, Aa^Fpa, Aa^Fpa, Aa^Vea, Aa^Fpa, Aa^Fpa, Aa^Fpa, Aa^Fpa, Aa^Fpa, Aa, Rra, Aa^Fpa, Aa^Fma, Aa^Fpa, Aa^Fpa, Aa^Fma, Ww, Aa^Fpa, Aa^Fpa, Aa^Fpa, Ww, Ww, Aa^Fpa, Aa^Fma, Aa, Aa, Aa, Aa^Fpa, Aa^Fpa, Aa^Fpa, Aa^Fpa, Ha, Aa^Fpa, Ha, Ha, Ha, Ha, Ha, Ha^Fpa, Ha, Rra, Rra, Ha, Ha, Ms, Ms, Ms
Ha, Re, Re, Ha, Ha, Aa, Aa, Aa, Re^Es, Aa, Aa, Aa, Aa, Aa^Fpa, Aa^Fpa, Aa^Fpa, Aa^Fpa, Aa^Fma, Aa^Fpa, Aa^Fpa, Aa^Fpa, Aa^Vea, Aa^Fpa, Aa^Fpa, Rra, Aa^Fpa, Aa^Fpa, Aa^Fma, Ww, Ww, Aa^Fpa, Ww, Ww, Ww, Aa^Fpa, Aa^Fpa, Aa, Aa^Fpa, Aa^Fpa, Aa, Aa^Fpa, Aa^Fpa, Aa^Fpa, Aa^Fpa, Aa^Feta, Aa^Fma, Aa^Fpa, Ha, Aa^Fpa, Aa^Fma, Aa^Fpa, Aa^Fpa, Rra, Rra, Aa^Fpa, Ha, Aa^Fpa, Ms, Ha, Ha, Ms
Ha, Ha, Ha, Re, Re, Cea, Cea, Re, Re^Es, Aa^Vea, Aa, Aa, Aa, Aa^Fpa, Aa^Fpa, Aa^Fpa, Aa^Fpa, Aa^Fpa, Aa^Fpa, Aa, Aa^Fpa, Aa^Fpa, Ww, Ww, Ww^Bsa|, Ww, Ww, Ww, Aa^Fma, Aa^Fma, Aa^Fma, Aa^Fpa, Aa^Fpa, Aa^Fpa, Aa^Fpa, Aa^Fpa, Aa, Aa^Fpa, Aa^Fpa, Aa^Esa, Aa^Fpa, Aa^Fpa, Aa^Fma, Aa^Fpa, Aa^Fpa, Aa^Fpa, Aa^Fma, Aa^Fma, Aa^Fpa, Aa^Fpa, Rra, Rra, Aa^Fpa, Aa^Vea, Aa^Fpa, Aa^Fpa, Aa^Fpa, Ha, Ha, Ha^Fpa, Ms
Ha, Ha, Ha, Aa, Re, Cea, 5 Kea, Cea, Re, Aa, Aa, Aa, Aa, Aa, Aa^Fma, Aa^Fpa, Aa^Fpa, Aa^Fpa, Aa^Fpa, Aa, Aa^Fma, Aa^Fpa, Ww, Cva, Cva, Cva, Ww, Aa^Fma, Aa^Fpa, Aa^Fpa, Aa^Fpa, Aa^Fma, Aa^Fpa, Aa^Fma, Aa^Fma, Aa^Fpa, Aa^Fpa, Aa^Fpa, Aa^Fpa, Aa^Fpa, Aa^Vea, Aa^Fpa, Aa^Fpa, Aa^Fpa, Aa^Fma, Aa^Fpa, Aa^Fma, Aa^Fma, Rra, Rra, Aa^Fpa, Aa^Fpa, Aa, Aa^Fpa, Aa^Fma, Aa^Fma, Aa^Fpa, Aa^Fpa, Aa^Fpa, Ha^Fpa, Ms
Aa, Ha, Aa, Aa, Aa, Re^Es, Re, Re, Cea, Cea, Re, Aa, Aa, Aa^Fpa, Aa^Fpa, Aa^Fpa, Aa^Fpa, Aa^Fpa, Aa, Aa, Aa^Fpa, Aa^Fpa, Ww, Cva, 7 Kva, Cva, Ww, Aa^Fpa, Aa^Fpa, Aa^Fpa, Aa^Fpa, Aa, Aa^Fpa, Aa^Fpa, Aa^Vea, Aa^Fpa, Aa^Fpa, Aa^Fpa, Aa, Aa^Fpa, Aa^Fpa, Aa^Fpa, Aa, Cva, 6 Kva, Cva^Es, Rra, Rra, Aa^Fpa, Aa^Fpa, Aa, Aa, Aa^Fpa, Aa^Fpa, Aa^Fpa, Aa^Fpa, Ha, Aa^Fpa, Ha, Ha, Ha
Aa, Aa, Aa, Aa, Aa, Aa, Re, Cea, Re, Re, Aa, Aa, Aa, Aa^Fpa, Aa^Fpa, Aa^Fpa, Aa^Fpa, Aa^Feta, Aa, Aa^Fpa, Aa^Fpa, Ww, Cva, Cva, Cva, Cva, Cva, Ww, Aa^Fma, Aa^Fpa, Aa^Fpa, Aa^Fma, Aa^Feta, Aa^Fpa, Aa^Fpa, Aa^Fpa, Aa, Aa, Aa^Fpa, Aa^Fpa, Aa^Fpa, Aa^Fpa, Aa, Cva^Es, Aa^Fpa, Cva^Es, Rra, Aa^Fma, Aa^Fma, Aa^Fma, Aa^Fpa, Aa, Aa^Fpa, Aa^Fpa, Aa^Fpa, Ha, Aa^Feta, Ha, Ha, Ha, Ha
Aa, Aa, Ha, Aa, Ha, Aa, Aa, Rra, Rra, Aa, Aa, Aa, Aa, Aa, Aa^Fpa, Aa^Fpa, Aa^Fpa, Aa, Aa^Fpa, Aa^Fpa, Aa, Ww, Ww, Ww, Ww^Bsa|, Ww, Ww, Ww, Aa^Fma, Aa^Fpa, Aa^Fpa, Aa^Fpa, Aa^Fpa, Aa^Fma, Aa^Fpa, Aa^Fpa, Aa^Fpa, Aa^Fpa, Aa^Fpa, Aa, Aa, Aa^Fpa, Aa^Fpa, Aa^Fpa, Rra, Rra, Aa^Vea, Aa^Fpa, Aa^Fpa, Aa^Fma, Aa, Aa, Aa^Fpa, Aa^Fpa, Aa^Fpa, Aa^Fpa, Ha, Ha, Ms, Ms, Ms
Aa, Aa, Ha, Ha, Aa, Aa, Aa, Aa, Aa, Rra, Aa, Aa, Aa, Aa, Aa^Fma, Aa^Fpa, Aa^Fpa, Aa^Fpa, Aa^Fpa, Aa^Fpa, Aa^Fpa, Aa^Fpa, Ww, Aa^Fpa, Rra, Aa^Fpa, Aa^Fpa, Aa^Fma, Aa^Vea, Aa^Fma, Aa^Fpa, Aa^Fpa, Aa^Fpa, Aa^Fma, Aa, Aa^Fpa, Aa^Fpa, Aa^Fpa, Aa^Fpa, Aa^Fma, Aa^Fpa, Aa^Fpa, Aa^Fpa, Aa^Fpa, Rra, Aa^Fpa, Aa^Fpa, Aa^Fpa, Aa^Fma, Aa^Fpa, Aa^Fpa, Aa^Fpa, Aa^Fpa, Aa^Fpa, Ha, Ha, Ha, Ha, Ha, Ms, Ms
Aa, Aa, Aa, Ha, Ha, Aa, Aa, Aa, Aa, Rra, Aa, Aa, Aa, Aa^Fma, Aa^Fma, Aa^Fpa, Aa^Fpa, Aa^Vea, Aa^Fpa, Aa^Fpa, Ww, Ww, Aa^Fma, Aa^Es, Aa^Fpa, Rra, Rra, Aa^Fpa, Aa^Fma, Aa^Fma, Rra, Aa^Fma, Aa^Fma, Aa^Fpa, Aa, Aa, Aa, Aa^Fpa, Aa^Fma, Aa^Fma, Aa^Fma, Aa^Vea, Aa^Fpa, Aa^Fma, Rra, Aa^Fpa, Aa^Fpa, Aa^Fpa, Aa^Fpa, Aa^Fpa, Aa^Fma, Aa^Fpa, Aa^Fpa, Aa^Fma, Ha, Ha, Aa^Fpa, Ha, Ha, Ms, Ms
Aa, Aa, Aa, Aa, Aa^Vea, Aa, Aa, Aa, Aa, Rra, Rra, Aa, Aa, Aa^Fma, Aa^Fpa, Aa^Fpa, Aa^Fpa, Aa^Fpa, Aa^Fpa, Aa^Fpa, Ww, Aa^Fpa, Aa, Aa, Aa^Fpa, Aa^Fpa, Aa^Fpa, Rra, Rra, Rra, Aa^Fpa, Rra, Rra, Aa^Fpa, Aa^Es, Aa^Fpa, Aa^Fpa, Aa^Fpa, Aa^Fpa, Aa^Fpa, Aa^Fpa, Aa, Rra, Rra, Aa, Aa^Fma, Aa^Fma, Aa^Fpa, Aa^Fpa, Aa^Fpa, Aa^Fpa, Aa^Fma, Aa, Aa^Fpa, Aa^Fpa, Aa^Fpa, Ha, Ha, Ms, Ms, Ms
Aa, Aa, Aa, Aa, Aa, Aa, Aa, Aa, Aa, Aa, Rra, Aa, Aa, Aa, Aa^Fma, Aa^Fpa, Aa^Fma, Aa^Fma, Ww, Ww, Aa^Fpa, Aa^Fma, Aa, Aa, Aa, Aa^Fpa, Aa^Fpa, Aa^Fpa, Aa^Fpa, Aa^Fpa, Aa^Fpa, Aa^Fma, Aa^Fpa, Rra, Rra, Aa^Fpa, Aa^Fpa, Aa^Fma, Aa^Fpa, Aa^Fpa, Aa^Fpa, Aa^Fma, Rra, Aa, Aa^Fma, Aa^Fma, Aa^Fma, Aa^Fma, Aa^Fpa, Aa^Fpa, Aa^Fpa, Aa^Fpa, Aa^Fma, Aa^Fma, Aa^Fpa, Aa^Fma, Ha, Ha, Ms, Ms, Ha
Aa, Aa, Aa, Aa, Aa, Aa, Aa, Aa, Aa, Aa, Aa^Vea, Rra, Rra, Aa, Aa^Fma, Aa^Fma, Aa^Fpa, Ww, Aa^Fpa, Aa^Fpa, Aa^Fpa, Aa^Fpa, Aa^Fpa, Aa^Fma, Aa^Fpa, Aa, Aa^Fpa, Aa, Aa^Fpa, Aa^Fma, Aa^Fpa, Aa^Fpa, Aa, Aa, Aa, Rra, Aa^Fpa, Aa^Feta, Aa^Fpa, Aa, Aa^Fpa, Aa^Fpa, Rra, Aa, Aa, Aa^Fpa, Aa^Fpa, Aa^Fpa, Aa^Fpa, Aa^Fpa, Aa^Fpa, Aa^Fpa, Aa^Fpa, Aa^Fma, Ha^Fpa, Ha^Fpa, Ha, Ha, Ha, Ha, Ha
Aa, Aa, Aa, Aa, Aa, Aa, Aa, Aa, Aa, Aa, Aa, Aa, Rra, Aa, Aa^Fma, Aa^Fpa, Aa^Fma, Ww, Aa^Fpa, Aa^Fpa, Aa^Vea, Aa^Fpa, Aa^Fpa, Aa^Fpa, Aa^Fpa, Aa^Feta, Aa^Fpa, Aa^Fpa, Aa^Fpa, Aa^Fpa, Aa^Vea, Aa^Fpa, Aa^Fma, Aa, Aa^Fma, Rra, Aa^Fpa, Aa^Fpa, Aa^Fma, Aa^Fma, Rra, Rra, Aa^Fpa, Aa, Aa^Fpa, Aa^Fpa, Aa^Fpa, Aa^Fpa, Aa^Fpa, Aa^Vea, Aa^Fma, Aa^Fpa, Aa^Fpa, Aa^Fpa, Ha, Ha, Ha^Fpa, Ha, Ha, Ha, Ha
Aa, Aa, Aa, Aa, Aa, Aa, Aa, Aa, Aa, Aa, Aa, Aa, Rra, Aa, Aa^Fpa, Aa^Fpa, Aa^Fpa, Ww, Aa^Fpa, Aa^Fpa, Aa^Fpa, Aa^Fma, Aa^Fma, Aa^Fpa, Aa^Fpa, Aa^Fpa, Aa^Fpa, Aa^Fpa, Aa^Fma, Aa^Fpa, Aa^Fpa, Aa^Fpa, Aa^Fma, Aa^Fpa, Aa^Fma, Rra, Aa^Fpa, Aa^Fpa, Rra, Rra, Aa^Fpa, Aa^Fma, Aa^Fpa, Aa^Fpa, Aa^Fpa, Aa^Fpa, Aa^Fpa, Aa, Aa^Fpa, Aa^Fpa, Aa^Fma, Aa^Fpa, Aa^Fma, Ha, Ha, Ha, Ha, Ha, Ww, Ww, Ww
Aa, Aa, Aa, Aa, Aa, Aa, Aa, Aa, Aa, Aa, Aa, Aa, Rra, Aa, Aa, Aa^Fpa, Ww, Ww, Aa^Fpa, Aa^Fpa, Aa^Fpa, Aa^Fpa, Aa, Aa^Fpa, Aa^Fpa, Aa^Fma, Aa^Fpa, Aa, Aa, Aa^Fpa, Rra, Aa^Fpa, Aa^Fpa, Aa^Fma, Aa, Rra, Rra, Rra, Aa^Fpa, Aa^Fpa, Aa^Fpa, Aa, Aa^Fpa, Aa^Fpa, Aa^Fpa, Aa^Fma, Aa, Aa^Fpa, Aa^Fpa, Aa^Fpa, Aa^Fma, Aa^Fpa, Aa^Fpa, Aa^Fpa, Aa^Feta, Aa^Fma, Ha, Ha, Ww, Ha, Ha
Aa, Aa, Aa, Aa^Vea, Aa, Aa, Aa, Aa, Aa, Aa, Aa, Aa, Wwg^Bsa|, Aa, Ww, Ww, Aa^Fpa, Aa^Fma, Aa^Fpa, Aa, Aa^Fpa, Aa^Fpa, Aa^Fpa, Aa^Fpa, Aa^Fpa, Aa^Fpa, Aa, Aa, Rra, Rra, Aa^Fpa, Rra, Rra, Aa^Fpa, Rra, Rra, Rra, Aa^Fpa, Aa^Fpa, Aa^Fma, Aa, Aa, Aa, Aa^Fpa, Aa^Feta, Aa^Fpa, Aa, Aa^Fpa, Aa, Aa^Fma, Aa^Fma, Aa^Fma, Aa^Fpa, Aa^Fpa, Aa^Fpa, Aa^Fpa, Ww, Ww, Ha, Ha, Ms
Aa, Aa, Aa, Aa, Aa, Aa, Aa, Aa, Aa, Aa, Wwg, Wwg, Rra, Wwg, Ai, Aa, Aa^Fpa, Aa^Fma, Aa, Aa, Aa^Fpa, Aa^Fpa, Aa^Fpa, Aa^Fpa, Aa^Fpa, Aa, Aa^Fpa, Rra, Aa, Aa, Aa^Fma, Aa^Fpa, Aa^Fpa, Rra, Aa^Fpa, Aa^Fpa, Aa^Fpa, Rra, Rra, Aa^Fpa, Aa^Fpa, Aa, Aa^Fpa, Aa^Fpa, Aa^Fpa, Aa^Fma, Aa^Fpa, Aa^Fpa, Aa, Aa^Fpa, Aa^Fma, Aa^Fpa, Aa^Fpa, Aa^Fpa, Aa^Fpa, Ww, Ha, Ha, Ms, Ms, Ms
Ai, Ai, Ai, Aa, Ai, Ai, Ww, Ww, Ww, Ww, Aa, Aa, Rra, Aa, Aa, Aa^Fpa, Aa^Fpa, Aa^Fpa, Aa^Fpa, Aa^Es, Aa, Aa^Fpa, Aa^Fpa, Aa^Fpa, Aa^Fma, Aa^Fpa, Aa^Vea, Rra, Aa^Fpa, Aa^Fma, Aa^Fpa, Aa^Fma, Aa^Fpa, Aa^Fpa, Aa^Fpa, Aa^Fpa, Aa^Fpa, Aa, Rra, Aa^Fma, Aa^Fma, Aa^Fpa, Aa, Aa^Fma, Aa^Fma, Aa^Fpa, Aa^Fma, Aa^Fpa, Aa^Fma, Aa^Fpa, Aa^Fpa, Aa^Fpa, Aa, Aa^Fpa, Ww, Ww, Ha, Ha^Fpa, Ha^Fpa, Ms, Ha
Ww, Ww, Ww, Ww, Ww, Ww, Aa, Aa, Aa, Aa, Aa, Aa, Rra, Aa, Aa, Aa, Aa^Fma, Aa^Vea, Aa^Fpa, Aa^Fpa, Aa, Aa^Fpa, Aa^Fpa, Aa^Fpa, Aa, Aa^Fma, Aa^Fpa, Rra, Aa^Fma, Aa, Aa^Fpa, Aa^Fpa, Aa^Fpa, Aa^Fma, Aa^Fma, Aa^Fpa, Aa, Aa, Rra, Aa^Fpa, Aa^Fma, Aa^Fma, Aa^Fpa, Aa^Fpa, Aa^Fpa, Aa^Fpa, Aa^Fma, Aa^Fma, Aa^Fpa, Aa^Fma, Aa^Fpa, Aa, Ww, Ww, Aa^Fma, Aa^Fpa, Ha, Ha, Ha, Ha, Aa^Fpa
Wo, Wo, Ww, Ww, Ai, Aa, Aa, Aa, Aa, Aa, Aa, Aa, Rra, Aa^Vea, Aa, Aa, Aa^Fma, Aa^Fpa, Aa^Fma, Aa, Aa^Fpa, Aa^Fma, Aa^Fma, Aa^Fma, Aa^Fpa, Aa, Rra, Rra, Aa^Fpa, Aa^Fpa, Aa^Fma, Aa^Fpa, Aa^Fpa, Aa^Fpa, Aa^Fma, Aa, Aa^Fma, Aa, Rra, Aa^Fma, Aa^Fpa, Aa^Vea, Aa^Fpa, Aa^Fpa, Aa^Fpa, Aa, Aa^Fma, Aa^Fpa, Ww, Aa^Fpa, Ww, Ww, Aa, Aa^Fpa, Aa^Fpa, Aa^Fpa, Ha, Aa^Fpa, Aa^Fma, Aa^Fpa, Aa^Fma
Ww, Ww, Ai, Ai, Ai, Aa, Aa, Aa, Aa, Aa, Aa, Aa, Rra, Aa, Aa, Aa, Aa, Aa^Fpa, Aa^Fpa, Aa, Aa^Fpa, Aa^Fpa, Aa, Aa, Rra, Rra, Aa^Fpa, Aa^Fpa, Aa^Fpa, Aa^Fpa, Aa^Esa, Aa^Fma, Aa^Fpa, Aa^Fpa, Aa^Fpa, Aa^Fpa, Aa^Feta, Aa^Fma, Rra, Aa^Fpa, Aa^Fpa, Aa^Fma, Aa^Fpa, Aa^Fpa, Ww, Aa^Fpa, Ww, Ww, Aa^Fpa, Ww, Aa, Aa, Aa^Fpa, Aa^Fpa, Aa^Fpa, Aa^Fpa, Aa^Fpa, Aa^Fpa, Aa^Fma, Aa^Fpa, Aa^Fpa
Aa, Aa, Ai, Aa, Aa, Aa, Aa, Aa, Aa, Aa, Aa, Aa, Rra, Aa, Aa, Aa, Aa, Aa^Fpa, Aa, Aa^Fpa, Aa^Fpa, Aa, Rra, Rra, Aa, Aa, Aa^Fma, Aa^Es, Aa^Fpa, Aa^Vea, Aa, Aa^Fma, Aa^Fpa, Aa^Fma, Aa^Fma, Aa^Fpa, Aa^Fpa, Aa^Fpa, Aa^Fpa, Rra, Ww, Aa^Fpa, Ww, Ww, Aa^Fma, Ww, Aa^Fpa, Aa^Fma, Aa^Fpa, Aa^Fma, Aa^Fma, Aa^Fpa, Aa^Esa, Aa^Fpa, Aa^Fma, Aa^Fpa, Aa^Fpa, Aa^Fpa, Aa^Fpa, Aa^Fpa, Aa^Fpa
Aa, Aa, Aa, Aa, Aa, Aa, Aa^Vea, Aa, Aa, Aa, Aa, Aa, Aa, Rra, Rra, Aa, Aa, Aa, Aa, Aa^Fpa, Aa^Fma, Rra, Aa^Fpa, Aa^Fpa, Aa, Aa^Fpa, Aa^Fpa, Aa^Fpa, Aa^Fpa, Aa, Aa, Aa^Fpa, Aa^Fpa, Aa^Fpa, Aa^Fpa, Aa^Fpa, Aa^Fpa, Aa^Fma, Ww, Ww^Bsa|, Aa^Fpa, Ww, Aa^Fpa, Aa^Fma, Aa^Fma, Aa^Fpa, Aa^Fpa, Aa^Fpa, Aa^Fpa, Aa^Fma, Aa^Fpa, Aa^Fpa, Aa^Fpa, Aa^Fpa, Aa^Fpa, Aa^Fpa, Aa^Feta, Aa^Fpa, Aa^Fma, Aa^Fma, Aa^Fpa
Aa, Aa, Aa, Aa, Aa, Aa, Aa, Aa, Aa, Aa, Aa, Aa, Aa, Aa, Aa, Rra, Aa, Aa, Aa, Aa, Aa^Fpa, Rra, Aa, Aa^Fpa, Aa^Fpa, Aa^Fpa, Aa^Fpa, Aa^Fpa, Aa^Fma, Aa^Fpa, Aa^Fpa, Aa^Fpa, Aa^Fpa, Aa^Fma, Aa^Fma, Aa^Fpa, Ww, Ww, Aa^Fpa, Rra, Rra, Aa^Fma, Aa^Fpa, Cva^Es, Cva^Edt, Cva^Edt, Aa, Aa^Vea, Aa^Fpa, Aa^Fpa, Aa^Fpa, Aa^Fpa, Aa^Fpa, Aa^Fma, Aa^Fpa, Aa, Aa^Fpa, Aa^Fpa, Aa^Fpa, Aa^Fpa, Aa^Fpa
Aa, Aa, Aa, Aa, Aa, Aa, Aa, Aa, Aa, Aa, Aa, Aa, Aa, Aa, Aa^Vea, Rra, Aa, Aa, Aa, Aa^Fpa, Rra, Rra, Aa^Fpa, Aa^Fpa, Aa^Fma, Aa^Feta, Aa^Fma, Aa^Fpa, Aa^Fma, Aa^Fpa, Aa^Fma, Aa^Fpa, Aa^Fpa, Aa^Fpa, Ww, Ww, Aa^Fpa, Aa^Fpa, Aa, Aa^Fma, Cva^Edt, Rra, Rra, Kva^Es, Cva^Edt, Aa, Aa^Fpa, Aa^Fpa, Aa^Fpa, Aa^Fpa, Aa^Fma, Aa^Fpa, Aa^Fpa, Aa^Fma, Aa^Vea, Aa, Aa^Fpa, Aa^Fpa, Aa^Fpa, Aa^Fpa, Aa^Fpa
Aa, Aa, Aa, Aa, Aa, Aa, Aa, Aa, Aa, Aa, Aa, Aa, Aa, Aa, Aa, Rra, Rra, Rra, Rra, Rra, Aa, Aa, Aa^Fpa, Aa^Fma, Aa^Fpa, Aa^Fpa, Aa^Fpa, Aa, Aa^Fpa, Aa^Fpa, Aa^Fpa, Aa^Fpa, Aa^Fma, Aa^Fma, Ww, Aa^Fpa, Aa^Fpa, Aa, Aa^Fma, Aa, Cva^Edt, 3 Kva, Rra, Rra, Aa, Aa, Aa, Aa^Fpa, Aa^Fpa, Aa^Fpa, Aa^Fpa, Aa^Fpa, Aa^Fpa, Aa, Aa^Fpa, Aa^Fpa, Aa^Fma, Aa^Fpa, Aa^Fpa, Aa^Fma, Aa^Fpa
Aa, Aa, Aa, Aa, Aa, Aa, Aa, Aa, Aa, Aa, Aa, Aa, Aa, Aa, Aa, Rra, Aa, Aa, Aa, Aa, Aa, Aa, Aa, Aa^Fma, Aa^Fpa, Aa^Fpa, Aa^Fpa, Aa^Fma, Aa^Fpa, Aa^Fpa, Aa^Fpa, Aa^Fma, Aa^Fpa, Aa^Fpa, Ww, Aa^Fpa, Aa^Fpa, Aa^Fma, Aa^Fpa, Cva^Edt, Aa, Cva^Edt, Rra, Rra, Aa^Fpa, Aa^Fpa, Aa^Fpa, Aa^Fpa, Aa^Fpa, Aa^Fpa, Aa^Fpa, Aa^Fpa, Aa^Fma, Aa^Fma, Aa^Fpa, Aa^Fpa, Aa^Fpa, Aa^Fpa, Aa^Fpa, Aa^Fpa, Aa^Fpa
Aa, Aa, Aa, Aa, Aa, Aa, Aa, Aa, Aa, Aa, Aa, Aa, Aa, Aa, Rra, Rra, Aa, Aa, Aa, Aa, Aa, Aa, Aa, Aa^Fpa, Aa^Fpa, Aa^Fpa, Aa^Fpa, Aa^Fpa, Aa, Aa^Vea, Aa^Fpa, Aa^Fpa, Ww, Ww, Aa^Fma, Aa^Fpa, Aa^Fpa, Aa^Vea, Aa^Fpa, Aa^Fma, Aa^Fpa, Aa^Fpa, Aa^Fpa, Rra, Aa^Fpa, Aa^Feta, Aa^Fpa, Aa^Fpa, Aa^Fpa, Aa^Fpa, Aa^Fpa, Aa^Fpa, Aa^Fpa, Aa^Fma, Aa^Fpa, Aa^Fpa, Aa^Fpa, Aa^Fma, Aa^Fpa, Aa^Fma, Aa^Fpa
Aa, Aa, Aa, Aa, Aa, Aa, Aa, Aa, Aa, Aa, Aa, Aa, Rra, Rra, Aa^Vea, Aa, Aa, Aa, Aa, Aa, Aa, Aa, Aa, Aa^Fma, Aa^Fma, Aa^Fpa, Aa^Fpa, Aa^Fma, Aa, Aa^Fpa, Aa^Fpa, Aa^Fpa, Ww, Aa^Fpa, Aa^Fpa, Aa^Fpa, Aa^Fpa, Aa^Fpa, Aa^Fpa, Aa, Aa, Aa^Fpa, Aa^Vea, Rra, Aa^Fpa, Aa^Fpa, Aa, Aa^Es, Aa^Fma, Aa^Fpa, Aa^Fpa, Ha^Fpa, Aa^Fpa, Aa^Fpa, Aa^Fma, Aa^Fpa, Aa^Fpa, Aa^Fpa, Aa^Fma, Aa^Fpa, Aa^Fpa
Aa, Aa, Aa, Aa, Aa, Aa, Aa, Aa, Aa, Aa, Aa, Rra, Aa, Aa, Aa, Aa, Aa, Aa, Aa, Aa, Aa, Aa, Aa, Aa^Fpa, Aa, Aa^Fpa, Aa^Fpa, Aa^Fpa, Aa^Fma, Aa^Fpa, Ww, Ww, Aa^Fpa, Aa^Fma, Aa^Fpa, Aa^Fma, Aa^Fpa, Aa^Fpa, Aa, Aa, Aa^Fpa, Aa^Fpa, Aa^Fpa, Rra, Aa, Aa, Aa, Aa^Fma, Aa^Fpa, Aa^Fpa, Aa^Fpa, Aa^Fpa, Aa^Fpa, Aa, Aa^Vea, Aa^Fpa, Aa^Fpa, Aa^Fpa, Aa^Fpa, Aa^Fma, Aa^Fpa
Ww, Ww, Ww, Aa, Aa, Aa, Aa, Aa, Aa, Aa, Aa, Rra, Aa, Aa, Aa, Aa, Aa, Aa, Aa, Aa, Aa^Fpa, Aa^Fpa, Aa^Fpa, Aa, Aa, Aa, Aa^Fpa, Aa^Fma, Ww, Ww, Aa^Fpa, Aa^Fpa, Aa^Fpa, Aa^Fma, Aa^Fpa, Aa^Fma, Aa^Fpa, Aa, Aa^Fma, Aa, Aa^Fma, Aa^Fpa, Rra, Rra, Aa, Aa, Aa^Fpa, Aa^Fpa, Aa^Fpa, Aa^Fma, Aa^Fma, Aa^Fpa, Aa, Aa, Aa, Aa^Fma, Aa^Fpa, Aa^Fma, Aa^Fpa, Aa^Fma, Aa^Fpa
Aa, Aa, Aa, Ww, Aa, Aa, Aa, Aa, Aa, Aa, Aa, Rra, Rra, Aa, Ww, Ww, Ww, Ww, Ww, Aa, Aa^Fpa, Aa^Fpa, Aa^Fpa, Aa^Fpa, Aa, Aa^Fma, Aa^Fpa, Aa^Fma, Ww, Aa^Fma, Aa^Fpa, Aa^Fpa, Aa^Fpa, Aa^Feta, Aa^Fpa, Aa^Fma, Aa, Aa^Fpa, Aa^Fpa, Aa^Fma, Rra, Rra, Aa^Esa, Rra, Rra, Aa^Vea, Aa^Fpa, Aa^Fpa, Aa^Fma, Aa^Fpa, Aa^Fpa, Aa^Fpa, Aa, Aa^Fma, Aa^Fpa, Aa^Fpa, Aa^Fpa, Aa^Fpa, Aa^Fpa, Aa^Fpa, Aa^Fpa
Aa, Aa, Aa, Ww, Ww, Ww, Ww, Aa, Aa, Aa, Aa, Aa, Aa, Ww^Bsa\, Rra, Aa, Aa, Aa, Aa, Ww, Ww, Ww, Ww, Aa^Fpa, Ww, Aa, Ww, Ww, Aa^Fpa, Aa^Fpa, Aa, Aa, Aa^Fpa, Aa^Fpa, Aa, Aa^Fpa, Aa^Fpa, Aa^Fpa, Aa^Fpa, Rra, Aa^Esa, Aa, Aa, Aa, Rra, Aa^Fpa, Aa^Fpa, Aa^Fpa, Aa^Fpa, Aa^Fpa, Aa^Fpa, Aa^Fpa, Aa^Fpa, Aa^Fpa, Aa^Fpa, Aa^Fpa, Aa^Fpa, Aa^Fpa, Aa^Fpa, Aa^Fma, Aa^Fpa
Aa, Aa, Aa, Aa, Aa, Aa, Aa, Ww, Aa, Aa, Aa, Aa, Ww, Ww, Cea, Rra, Rra, Aa, Aa, Aa, Aa, Aa, Aa, Ww, Aa, Ww, Aa^Fma, Aa^Fpa, Aa^Fpa, Aa^Vea, Aa, Aa, Aa^Fpa, Aa^Fpa, Aa^Fpa, Aa, Aa^Fpa, Aa^Fpa, Rra, Rra, Aa^Fpa, Aa^Fpa, Aa^Fma, Aa^Fpa, Rra, Aa^Fpa, Aa^Fpa, Aa^Fpa, Aa^Fma, Aa^Fpa, Aa^Fpa, Aa^Fpa, Aa^Fpa, Aa^Fpa, Aa^Fpa, Aa^Fpa, Aa^Fpa, Aa^Fpa, Aa^Fpa, Aa^Fpa, Aa^Fpa
Aa, Aa, Aa, Aa^Vea, Aa, Aa, Aa, Ww, Ww, Ww, Ww, Ww, Cea, Cea, 4 Kea, Cea, Rra, Aa, Aa, Aa, Aa, Aa, Aa, Aa, Aa, Aa, Aa, Aa^Fpa, Aa^Fpa, Aa, Aa^Fpa, Aa^Fma, Rra, Rra, Rra, Aa^Es, Rra, Rra, Aa, Aa^Fpa, Aa^Fpa, Aa^Fma, Aa^Fpa, Aa^Fpa, Rra, Aa^Fpa, Aa^Fpa, Cea, Cea, Aa^Fpa, Aa^Fpa, Aa^Fma, Aa^Fpa, Aa^Fpa, Aa^Fpa, Aa^Fma, Aa^Fpa, Aa^Vea, Aa^Fpa, Aa^Fpa, Aa^Fma
Rra, Rra, Rra, Rra, Rra, Aa, Aa, Aa, Aa, Aa, Aa, Aa, Cea, Cea, Cea, Cea, Rra, Rra, Rra, Rra, Rra, Aa, Aa, Aa, Aa, Aa, Aa, Aa, Aa^Fma, Aa^Fma, Rra, Rra, Aa^Fma, Aa^Fpa, Aa^Fpa, Rra, Aa, Aa, Aa^Vea, Aa^Fpa, Aa^Fpa, Aa^Fpa, Aa^Fpa, Aa^Fpa, Cea, Rra, Rra, Cea, 2 Kea, Cea, Aa^Fpa, Aa^Fma, Aa^Fpa, Aa^Fma, Aa^Fpa, Aa^Fpa, Aa, Aa^Fma, Aa^Fpa, Aa^Fpa, Aa^Fpa
Aa, Aa, Aa, Aa, Aa, Rra, Rra, Aa, Rra, Aa^Vea, Rra, Aa, Rra, Rra, Rra, Rra, Aa, Aa, Aa, Aa, Aa, Rra, Rra, Rra, Rra, Rra, Rra, Aa, Rra, Rra, Aa^Fma, Aa^Fma, Aa^Esa, Aa^Fpa, Aa^Fpa, Aa, Aa^Fpa, Aa^Fpa, Aa^Fpa, Aa^Fpa, Aa^Fpa, Aa^Fpa, Aa^Fpa, Aa^Fpa, Cea, Cea, 1 Kea, Rra, Aa^Fpa, Aa^Fpa, Aa^Fma, Aa, Aa^Fpa, Aa^Feta, Aa^Fma, Aa^Fpa, Aa, Aa^Fpa, Aa^Fma, Aa^Fpa, Aa^Fpa
Aa, Aa, Aa, Aa, Aa, Aa, Aa, Rra, Aa, Rra, Aa, Rra, Aa, Aa, Aa, Aa^Vea, Aa, Aa, Aa, Aa, Aa, Aa, Aa, Aa, Aa, Aa, Aa, Rra, Aa, Aa, Aa, Aa^Fpa, Aa^Fpa, Aa^Vea, Aa^Fpa, Aa, Aa^Fpa, Aa^Fpa, Aa^Fpa, Aa^Fpa, Aa, Aa^Fpa, Aa^Fma, Aa^Fpa, Aa^Fpa, Cea, Aa^Fpa, Rra, Aa^Fpa, Aa^Fpa, Aa^Fpa, Aa^Fpa, Aa^Fma, Aa^Fpa, Aa^Fpa, Aa, Aa^Fma, Aa^Fpa, Aa^Fpa, Aa^Fpa, Aa^Fpa
Aa, Aa, Aa, Aa, Aa, Aa, Aa, Aa, Aa, Aa, Aa, Aa, Aa, Aa, Aa, Aa, Aa, Aa, Aa, Aa, Aa, Aa, Aa, Aa, Aa, Aa, Aa, Aa, Aa, Aa, Aa, Aa, Aa^Fpa, Aa^Fma, Aa^Fma, Aa^Fma, Aa^Fpa, Aa^Fpa, Aa^Esa, Aa, Aa, Aa, Aa^Fpa, Aa^Fpa, Aa^Fpa, Aa^Fpa, Aa^Fpa, Rra, Aa^Fpa, Aa^Fma, Ww, Aa^Fpa, Aa^Fpa, Aa, Aa, Aa, Aa, Aa, Aa^Fpa, Aa^Fpa, Aa^Fpa
