Ha, Ha, Ha, Aa, Aa, Aa, Aa, Aa, Aa, Aa, Aa^Fpa, Aa^Fpa, Aa^Fpa, Aa^Fpa, Aa^Fpa, Aa^Fpa, Aa^Fpa, Aa^Fpa, Aa^Fpa, Aa^Fpa, Aa^Fpa, Aa, Aa^Fpa, Aa^Fpa, Aa^Fpa, Aa^Fpa, Aa^Fpa, Aa^Fpa, Aa^Fpa, Aa^Fpa, Aa^Fpa, Wwg, Aa^Fpa, Gll^Fp, Aa^Fpa, Aa^Fpa, Aa^Fpa, Aa^Fpa, Aa^Fpa, Aa^Fpa, Aa^Fpa, Aa^Fpa, Aa^Fpa, Aa^Fpa, Aa^Fpa, Aa^Fpa, Ha, Ha, Ha, Ms, Ms, Ms, Ms, Ha, Ha, Hh, Rra, Rra, Ha, Ha, Ha
Ha, Ha, Ha, Ha, Ha, Aa, Aa, Aa, Aa, Aa, Aa, Aa^Fpa, Aa^Fpa, Aa^Fpa, Aa^Fpa, Aa^Fpa, Aa^Fpa, Aa^Fpa, Aa^Fpa, Aa^Fpa, Aa^Fpa, Aa^Fpa, Aa^Fpa, Aa^Feta, Aa^Fpa, Aa^Fpa, Aa^Fpa, Aa^Fpa, Aa^Fpa, Aa^Fpa, Wwg, Wwg, Aa^Fpa, Aa^Fpa, Aa^Fpa, Aa^Fpa, Aa^Fpa, Aa^Fpa, Aa^Fpa, Aa^Fpa, Aa^Fpa, Aa^Fpa, Aa^Fpa, Aa^Fpa, Aa^Fpa, Ha, Ha, Ha^Fpa, Ms, Ms, Ms, Ms, Ms, Ha, Aa^Vea, Ha, Rra, Ha, Ha, Ms, Ms
Re, Ha, Ha, Ha, Ha, Aa, Aa, Aa, Ha, Aa, Aa, Aa, Aa^Fpa, Aa^Fpa, Aa^Fpa, Aa^Vea, Aa^Fpa, Aa^Fpa, Aa^Fpa, Aa^Fpa, Aa^Fpa, Aa^Fpa, Aa^Fpa, Aa^Fpa, Aa^Fpa, Ai, Wwg, Wwg, Wwg, Wwg, Aa^Fpa, Aa^Fpa, Aa^Fpa, Aa^Fpa, Aa^Fpa, Aa^Fpa, Aa^Fpa, Aa^Fpa, Aa^Fpa, Aa^Vea, Aa^Fpa, Aa^Fpa, Aa, Aa^Fpa, Aa^Fpa, Ha^Fpa, Ha^Fpa, Ms, Ha, Ms, Ha, Ms, Ha^Fpa, Ha, Ha, Rra, Ha, Ha, Ms, Ms, Ms
Ha, Re, Ha, Ha, Aa, Ha, Aa, Aa, Aa, Ha, Aa, Aa, Aa, Aa^Fpa, Aa^Fpa, Aa^Fpa, Aa^Fpa, Aa^Fpa, Aa, Aa^Fpa, Aa^Fpa, Aa^Fpa, Aa^Fpa, Aa, Wwg, Wwg, Aa^Fpa, Ss, Ss, Ss, Aa^Fpa, Aa^Feta, Aa^Fpa, Aa^Fpa, Aa^Fpa, Aa^Fpa, Aa^Fpa, Ss, Aa^Fpa, Aa^Fpa, Aa^Fpa, Aa^Fpa, Aa^Fpa, Aa^Fpa, Aa^Fpa, Ha, Aa^Fpa, Ha, Ha, Ha, Ha, Ha, Ha^Fpa, Ha, Rra, Rra, Ha, Ha, Ms, Ms, Ms
Ha, Re, Re, Ha, Ha, Aa, Aa, Aa, Re^Es, Aa, Aa^Esa, Aa, Aa, Aa^Fpa, Aa^Fpa, Aa^Fpa, Aa^Feta, Aa^Fpa, Aa^Fpa, Aa^Fpa, Aa^Fpa, Aa^Fpa, Ai, Aa^Fpa, Wwg, Aa^Fpa, Aa^Fpa, Aa^Fpa, Aa^Vea, Aa^Fpa, Aa^Fpa, Aa^Fpa, Ss, Aa^Fpa, Aa^Fpa, Aa^Fpa, Ss, Ss, Aa^Fpa, Aa^Fpa, Aa^Fpa, Aa^Fpa, Aa^Fpa, Aa^Fpa, Aa^Fpa, Aa^Fpa, Aa^Fpa, Ha, Aa^Fpa, Aa^Fpa, Aa^Fpa, Aa^Fpa, Rra, Rra, Aa^Fpa, Ha, Aa^Fpa, Ms, Ha, Ha, Ms
Ha, Ha, Ha, Re, Re, Cea, Cea, Re, Re^Es, Aa, Aa, Aa, Aa, Aa^Fpa, Aa^Fpa, Aa^Fpa, Aa^Fpa, Aa^Fpa, Aa^Fpa, Aa^Fpa, Aa^Fpa, Ai, Cva^Fet, Wwg, Wwg, Ai, Ai, Aa^Fpa, Aa^Fpa, Aa^Fpa, Aa^Fpa, Ss, Wwg, Aa^Fpa, Wwg, Aa^Fpa, Wwg, Wwg, Wwg, Ss, Ss, Aa^Fpa, Aa, Aa^Fpa, Aa^Fpa, Aa^Feta, Aa^Fpa, Aa^Fpa, Aa^Fpa, Aa^Fpa, Rra, Rra, Aa^Fpa, Aa^Vea, Aa^Fpa, Aa^Fpa, Aa^Fpa, Ha, Ha, Ha^Fpa, Ms
Ha, Ha, Ha, Aa, Re, Cea, 5 Kea, Cea, Re, Aa, Aa, Aa, Aa, Aa, Aa^Fpa, Aa^Fpa, Aa^Fpa, Aa^Fpa, Aa^Fpa, Aa^Fpa, Aa^Fpa, Ai, Wwg, Cva, Cva, Cva, Ai, Aa^Fpa, Wwg, Aa^Fpa, Aa^Fpa, Aa^Fpa, Ai, Wwg, Aa^Fpa, Wwg, Aa^Fpa, Aa^Fpa, Aa^Fpa, Aa^Fpa, Aa^Fpa, Aa^Fpa, Re, Re, Re, Aa^Fpa, Re, Aa^Fpa, Aa^Fpa, Aa^Fpa, Rra, Rra, Aa^Fpa, Aa^Fpa, Aa^Fpa, Aa^Fpa, Aa^Fpa, Aa^Fpa, Aa^Fpa, Ha^Fpa, Ms
Aa, Ha, Aa, Aa, Aa, Re^Es, Re, Re, Cea, Cea, Re, Aa, Aa, Aa^Fpa, Aa^Fpa, Aa^Fpa, Aa^Fpa, Aa^Vea, Aa^Fpa, Aa^Fpa, Aa^Fpa, Aa^Fpa, Wwg, Cva, 7 Kva, Cva, Wwg, Wwg, Aa^Fpa, Wwg, Ai, Ai, Aa^Fpa, Aa^Fpa, Ss, Ss, Ss, Aa^Fpa, Aa^Fpa, Aa^Vea, Aa^Fpa, Re, Re^Es, Cva^Es, 6 Kvr, Cva^Es, Re^Es, Re^Es, Rra, Rra, Aa^Fpa, Aa^Fpa, Aa^Fpa, Aa^Fpa, Aa^Fpa, Aa^Fpa, Ha, Aa^Fpa, Ha, Ha, Ha
Aa, Aa, Aa, Aa, Aa, Aa, Re, Aa^Vea, Re, Re, Aa, Aa, Aa, Aa^Fpa, Aa^Fpa, Aa^Fpa, Aa^Fpa, Aa^Fpa, Aa^Fpa, Aa^Fpa, Wwg, Wwg, Cva, Cva, Cva, Cva, Cva, Wwg, Ai, Aa^Fpa, Aa^Vea, Aa^Fpa, Aa^Fpa, Aa^Fpa, Aa^Fpa, Aa^Fpa, Aa^Fpa, Aa^Fpa, Aa^Fpa, Aa^Fpa, Aa^Feta, Aa^Fpa, Re^Es, Cva^Es, Re, Cva^Es, Rra, Rra, Aa^Fpa, Aa^Fpa, Aa^Fpa, Aa^Fpa, Aa^Fpa, Aa^Fpa, Aa^Fpa, Ha, Aa^Fpa, Ha, Ha, Ha, Ha
Aa, Aa, Ha, Aa, Ha, Aa, Aa, Rra, Rra, Aa, Aa, Aa, Aa, Aa, Aa^Fpa, Aa^Fpa, Aa^Fpa, Aa^Fpa, Aa^Fpa, Aa^Fpa, Rra, Wwg^Bsa/, Wwg, Wwg, Wwg, Wwg, Wwg, Wwg^Bsa\, Rra, Aa^Fpa, Aa^Fpa, Aa^Fpa, Rra, Aa^Fpa, Aa^Fpa, Aa^Fpa, Aa^Fpa, Ss, Aa, Aa^Fpa, Aa^Fpa, Aa^Fpa, Re, Re, Rra, Rra, Aa^Fpa, Aa^Fpa, Aa^Fpa, Aa^Fpa, Aa^Fpa, Aa^Fpa, Aa^Fpa, Aa^Fpa, Aa^Fpa, Aa^Fpa, Ha, Ha, Ms, Ms, Ms
Aa, Aa, Ha, Ha, Aa, Aa, Aa, Aa, Aa, Rra, Aa, Aa, Aa, Aa, Aa^Fpa, Aa^Fpa, Aa^Fpa, Aa^Fpa, Aa^Fpa, Aa^Fpa, Aa^Fpa, Aa^Fpa, Aa^Fpa, Aa^Fpa, Wwg, Aa^Fpa, Aa^Fpa, Aa^Fpa, Aa^Fpa, Rra, Rra, Rra, Aa^Fpa, Rra, Rra, Aa^Fpa, Aa^Fpa, Aa^Fpa, Aa^Fpa, Aa^Fpa, Aa^Fpa, Re^Es, Aa^Fpa, Rra, Aa^Fpa, Aa^Fpa, Aa^Fpa, Aa^Fpa, Aa^Fpa, Aa^Fpa, Ha^Fpa, Aa^Fpa, Aa^Fpa, Aa^Fpa, Ha, Ha, Ha, Ha, Ha, Ms, Ms
Aa, Aa, Aa, Ha, Ha, Aa, Aa, Aa, Aa, Rra, Aa, Aa^Vea, Aa, Aa^Fpa, Aa^Fpa, Aa^Fpa, Aa^Fpa, Aa^Fpa, Aa^Fpa, Aa^Fpa, Aa^Fpa, Aa^Fpa, Aa^Fpa, Aa^Fpa, Wwg, Aa^Fpa, Aa^Fpa, Aa^Fpa, Aa^Fpa, Aa^Fpa, Aa^Fpa, Aa^Fpa, Aa^Fpa, Aa^Fpa, Rra, Aa^Fpa, Aa^Fpa, Aa^Fpa, Aa^Vea, Aa^Fpa, Aa^Fpa, Aa^Fpa, Aa^Fpa, Rra, Aa^Fpa, Aa^Vea, Aa^Es, Aa^Fpa, Aa^Fpa, Aa^Fpa, Ha, Aa^Fpa, Aa^Fpa, Aa^Fpa, Ha, Ha, Aa^Fpa, Ha, Ha, Ms, Ms
Aa, Aa, Aa, Aa^Vea, Aa, Aa, Aa, Aa, Aa, Rra, Rra, Aa, Aa, Aa^Fpa, Aa^Fpa, Aa^Fpa, Aa^Fpa, Aa^Fpa, Aa^Fpa, Aa^Fpa, Aa^Fpa, Aa, Aa^Fpa, Aa^Fpa, Aa^Fpa, Wwg, Wwg, Ai, Aa^Fpa, Aa^Fpa, Aa^Fpa, Aa^Feta, Aa^Fpa, Aa^Fpa, Aa^Fpa, Rra, Rra, Aa^Fpa, Aa^Fpa, Aa, Rra, Aa^Fpa, Rra, Rra, Ha^Fpa, Aa^Fpa, Ha, Aa^Fpa, Ha^Fpa, Ha, Aa^Fpa, Aa^Fpa, Aa^Fpa, Aa^Fpa, Aa^Fpa, Aa^Fpa, Ha, Ha, Ms, Ms, Ms
Aa, Aa, Aa, Aa, Aa, Aa, Aa, Aa, Aa, Aa, Rra, Aa, Aa, Aa, Aa^Fpa, Aa^Fpa, Aa^Fpa, Aa^Fpa, Aa^Fpa, Aa^Fpa, Aa^Fpa, Aa^Fpa, Aa^Fpa, Aa^Fpa, Aa^Fpa, Aa^Fpa, Aa^Fpa, Ai, Ai, Aa^Fpa, Aa^Fpa, Aa^Fpa, Aa^Fpa, Aa^Fpa, Aa^Fpa, Aa^Fpa, Aa^Fpa, Rra, Rra, Rra, Rra, Rra, Rra, Ha, Ha, Ha, Ha^Fpa, Ha, Ha, Ha, Aa^Fpa, Aa^Fpa, Aa^Fpa, Aa^Vea, Aa^Fpa, Aa^Fpa, Ha, Ha, Ms, Ms, Ha
Aa, Aa, Aa, Aa, Aa, Aa, Aa, Aa, Aa, Aa, Aa, Rra, Rra, Aa, Aa^Fpa, Aa^Fpa, Aa^Fpa, Aa^Vea, Rra, Aa^Fpa, Rra, Aa^Fpa, Aa^Fpa, Aa^Fpa, Aa^Fpa, Aa^Fpa, Ai, Ai, Aa^Fpa, Aa^Fpa, Aa^Fpa, Aa^Fpa, Aa^Fpa, Aa^Fpa, Aa^Fpa, Aa^Fpa, Aa^Feta, Aa^Fpa, Aa^Fpa, Aa^Fpa, Aa^Fpa, Aa^Fpa, Aa^Fpa, Rra, Rra, Ha^Fpa, Ha, Ha, Ha, Ha^Fpa, Ha, Aa^Fpa, Aa^Fpa, Aa^Fpa, Ha^Fpa, Ha^Fpa, Ha, Ha, Ha, Ha, Ha
Ai, Ai, Ai, Ai, Ai, Aa, Aa, Aa, Aa^Esa, Aa, Aa, Aa^Vea, Rra, Aa, Aa^Fpa, Aa^Fpa, Aa^Es, Aa^Fpa, Aa^Fpa, Rra, Aa^Feta, Rra, Aa^Fpa, Aa^Fpa, Aa^Fpa, Aa^Fpa, Aa^Fpa, Wwg, Ss, Aa^Fpa, Aa^Fpa, Aa^Fpa, Aa^Fpa, Aa^Fpa, Aa^Fpa, Aa^Fpa, Aa^Fpa, Aa^Fpa, Aa, Aa^Fpa, Aa^Fpa, Aa^Fpa, Aa^Fpa, Rra, Rra, Ha, Aa^Fpa, Aa^Fpa, Aa^Fpa, Ha, Aa^Es, Ha, Aa^Fpa, Aa^Fpa, Ha, Ha, Ha^Fpa, Ha, Ha, Ha, Ha
Ai, Ai, Ai, Ai, Ai, Aa, Aa, Aa^Esa, Aa^Esa, Aa, Aa, Aa, Rra, Aa, Aa^Fpa, Aa^Fpa, Aa^Fpa, Aa^Fpa, Aa^Fpa, Rra, Aa^Fpa, Rra, Aa^Vea, Aa^Fpa, Aa^Fpa, Ss, Wwg, Wwg, Aa^Fpa, Aa^Fpa, Aa^Fpa, Aa^Fpa, Aa^Fpa, Aa^Fpa, Aa^Fpa, Aa^Fpa, Aa^Fpa, Aa^Fpa, Aa^Fpa, Aa^Fpa, Aa^Fpa, Aa^Fpa, Rra, Rra, Aa^Fpa, Rra, Rra, Aa^Fpa, Aa^Fpa, Aa^Fpa, Aa^Fpa, Aa^Fpa, Aa^Fpa, Ha, Ha, Ha, Ha, Ha, Ww, Ww, Ww
Wwg, Wwg, Wwg, Ai, Ai, Ai, Aa, Aa, Aa, Aa, Aa, Aa, Rra, Aa, Aa, Aa^Fpa, Aa^Fpa, Aa^Fpa, Aa^Fpa, Aa^Fpa, Aa^Fpa, Aa^Fpa, Aa^Fpa, Aa^Fpa, Aa^Fpa, Ss, Wwg, Aa, Ss, Ss, Aa^Fpa, Aa^Feta, Aa^Fpa, Aa^Fpa, Aa^Fpa, Aa^Fpa, Aa, Aa^Fpa, Rra, Rra, Rra, Rra, Aa^Fpa, Aa^Fpa, Aa^Fpa, Aa^Fpa, Aa^Fpa, Rra, Rra, Aa^Fpa, Aa^Fpa, Aa^Fpa, Aa^Fpa, Aa, Aa^Fpa, Aa^Fpa, Ha, Ha, Ww, Ha, Ha
Wwg, Wwg, Ai, Ai, Aa, Aa, Aa, Aa, Aa, Aa, Aa, Aa, Wwg^Bsa|, Aa, Aa, Aa^Fpa, Aa^Fpa, Aa, Aa^Fpa, Aa^Fpa, Aa^Fpa, Aa^Fpa, Aa^Fpa, Aa^Fpa, Aa^Fpa, Aa^Fpa, Wwg, Aa^Fpa, Ss, Aa^Fpa, Aa^Fpa, Aa^Fpa, Aa^Fpa, Aa^Fpa, Aa^Fpa, Aa^Fpa, Rra, Rra, Aa^Fpa, Aa^Fpa, Aa^Vea, Aa^Fpa, Aa^Fpa, Aa^Fpa, Aa^Feta, Aa^Fpa, Aa^Fpa, Rra, Rra, Aa^Fpa, Aa^Vea, Aa^Fpa, Ha, Aa^Fpa, Ha^Fpa, Aa^Fpa, Ww, Ww, Ha, Ha, Ms
Wwg, Wwg, Wwg, Ai, Wwg, Aa, Wwg, Aa, Wwg, Aa, Wwg, Wwg, Rra, Wwg, Ai, Aa, Wwg, Ai, Ai, Ai, Aa^Fpa, Aa^Fpa, Wwg, Aa^Fpa, Wwg, Wwg, Aa^Fpa, Aa^Fpa, Aa^Fpa, Aa, Ss, Aa^Fpa, Aa^Fpa, Aa^Vea, Aa^Fpa, Aa^Fpa, Rra, Rra, Aa^Fpa, Aa^Fpa, Aa^Fpa, Aa^Fpa, Aa^Fpa, Aa^Fpa, Aa^Fpa, Aa^Fpa, Aa^Fpa, Aa^Fpa, Rra, Aa^Fpa, Aa^Fpa, Aa^Fpa, Ha, Ha^Fpa, Ha, Ww, Ha, Ha, Ms, Ms, Ms
Ai, Wwg, Ai, Wwg, Ai, Wwg, Aa, Wwg, Aa, Wwg, Aa, Aa^Vea, Rra, Aa, Aa, Wwg, Aa^Fpa, Aa^Fpa, Aa, Ai, Ai, Wwg, Aa^Fpa, Wwg, Ss, Ai, Aa^Fpa, Aa^Fpa, Aa^Fpa, Aa^Fpa, Aa^Fpa, Aa^Fpa, Aa^Fpa, Aa^Fpa, Rra, Rra, Aa^Fpa, Aa^Fpa, Aa^Fpa, Aa^Fpa, Aa^Fpa, Aa^Fpa, Aa^Fpa, Aa^Fpa, Aa^Fpa, Aa^Fpa, Aa^Fpa, Aa^Fpa, Rra, Rra, Aa^Fpa, Ss, Ai, Ha, Ww, Ww, Ha, Ha^Fpa, Ha^Fpa, Ms, Ha
Ai, Ai, Ai, Ai, Aa, Aa, Aa, Aa, Aa, Aa, Aa, Aa, Rra, Aa, Aa, Aa, Aa^Fpa, Aa^Fpa, Aa^Fpa, Aa^Fpa, Ss, Aa^Fpa, Aa^Fpa, Ss, Aa^Fpa, Aa^Fpa, Ss, Aa^Fpa, Aa^Fpa, Aa^Fpa, Aa^Fpa, Aa^Fpa, Aa^Fpa, Rra, Rra, Aa^Fpa, Aa^Fpa, Aa^Fpa, Aa^Fpa, Aa^Fpa, Aa^Fpa, Aa^Fpa, Aa^Fpa, Aa^Fpa, Ss, Aa^Fpa, Aa^Fpa, Aa^Fpa, Aa^Fpa, Rra, Rra, Aa^Fpa, Ww, Ww, Ss, Ss, Ha, Ha, Ha, Ha, Aa^Fpa
Ai, Ai, Aa, Aa, Aa, Aa, Aa, Aa, Aa, Aa, Rra, Rra, Aa, Aa, Aa, Aa, Aa^Fpa, Aa^Vea, Aa^Fpa, Aa^Fpa, Aa^Fpa, Aa, Aa^Fpa, Aa, Aa^Fpa, Aa^Fpa, Aa^Fpa, Aa^Fpa, Aa^Fpa, Aa^Fpa, Aa^Fpa, Aa^Fpa, Rra, Rra, Aa^Fpa, Aa^Fpa, Aa^Fpa, Aa^Fpa, Aa^Fpa, Aa^Fpa, Ss, Aa^Fpa, Aa^Fpa, Ss, Ss, Aa^Fpa, Ss, Aa^Fpa, Aa^Fpa, Wwg, Wwg, Wwg^Bsa\, Rra, Aa^Fpa, Aa^Fpa, Aa^Fpa, Ha, Aa^Fpa, Aa^Fpa, Aa^Fpa, Aa^Fpa
Aa, Aa, Aa, Aa, Aa, Aa, Aa, Aa, Aa, Aa, Rra, Aa, Aa, Aa, Aa, Aa, Aa, Aa^Fpa, Aa^Fpa, Aa^Fpa, Aa^Feta, Aa^Fpa, Aa^Fpa, Aa^Vea, Aa^Fpa, Aa^Fpa, Rra, Rra, Rra, Aa^Fpa, Rra, Rra, Aa^Fpa, Aa^Fpa, Aa^Es, Aa^Fpa, Aa^Fpa, Aa^Fpa, Aa^Fpa, Ss, Aa^Fpa, Aa^Fpa, Ss, Ss, Ss, Ss, Aa^Fpa, Aa^Fpa, Wwg, Wwg, Aa^Fpa, Aa^Fpa, Aa^Fpa, Rra, Aa^Fpa, Aa^Fpa, Aa^Fpa, Aa^Fpa, Aa^Fpa, Aa^Fpa, Aa^Fpa
Aa, Aa, Aa, Aa, Aa, Aa, Aa^Esa, Aa, Aa, Aa^Vea, Rra, Aa, Aa, Aa, Aa^Esa, Aa, Aa, Aa^Fpa, Aa, Aa^Fpa, Aa^Fpa, Aa^Fpa, Aa^Fpa, Aa, Rra, Rra, Aa^Fpa, Aa, Aa^Fpa, Rra, Aa^Fpa, Rra, Rra, Aa^Vea, Aa, Aa^Fpa, Aa^Fpa, Aa^Fpa, Aa^Fpa, Aa^Fpa, Aa^Fpa, Aa^Fpa, Aa^Fpa, Aa^Fpa, Wwg, Wwg, Wwg, Ai, Aa^Fpa, Ai, Aa^Fpa, Aa^Fpa, Aa^Fpa, Rra, Aa^Vea, Aa^Fpa, Aa^Fpa, Aa^Fpa, Aa^Fpa, Aa^Fpa, Aa^Fpa
Aa, Aa, Aa, Aa, Aa, Aa, Aa, Aa^Esa, Aa, Aa, Aa, Rra, Aa, Aa, Aa, Aa, Aa, Aa, Aa, Aa^Fpa, Aa^Fpa, Aa^Fpa, Aa^Fpa, Rra, Aa^Fpa, Aa^Fpa, Aa^Fpa, Aa^Vea, Aa^Fpa, Aa^Fpa, Aa^Fpa, Rra, Rra, Aa^Fpa, Aa^Fpa, Aa^Fpa, Aa^Fpa, Aa^Feta, Aa^Fpa, Aa^Fpa, Ss, Aa^Fpa, Aa^Fpa, Wwg, Aa^Fpa, Aa^Fpa, Aa^Fpa, Ai, Aa^Fpa, Aa^Fpa, Aa^Fpa, Aa^Fpa, Rra, Rra, Ha^Fpa, Aa^Fpa, Aa^Fpa, Aa^Feta, Aa^Fpa, Aa, Aa^Fpa
Aa, Aa, Aa, Aa, Aa, Aa^Vea, Aa, Aa, Aa, Aa, Aa, Rra, Rra, Aa, Aa, Aa, Aa, Aa, Aa, Aa, Aa^Fpa, Aa^Fpa, Rra, Rra, Aa^Fpa, Aa^Fpa, Aa^Fpa, Aa^Fpa, Aa, Ss, Aa^Fpa, Aa, Rra, Rra, Aa^Fpa, Aa^Fpa, Aa^Fpa, Aa^Fpa, Aa^Fpa, Ss, Ss, Aa^Fpa, Wwg, Wwg, Aa^Fpa, Aa^Fpa, Aa^Vea, Aa^Fpa, Aa^Fpa, Aa^Fpa, Aa^Fpa, Aa^Fpa, Rra, Rra, Ha^Fpa, Aa^Fpa, Aa^Fpa, Aa^Fpa, Aa^Fpa, Aa^Fpa, Aa^Fpa
Aa, Aa, Aa, Aa^Fda, Aa, Aa, Aa, Aa, Aa, Aa, Aa, Aa^Vea, Aa, Rra, Rra, Aa, Aa, Aa, Aa, Aa^Fpa, Rra, Rra, Aa^Fpa, Aa^Fpa, Aa^Fpa, Aa^Fpa, Ss, Aa^Fpa, Aa^Fpa, Ss, Aa^Fpa, Aa^Fpa, Aa^Fpa, Rra, Rra, Aa^Fpa, Aa^Fpa, Aa^Fpa, Aa^Fpa, Aa^Fpa, Aa^Fpa, Aa^Fpa, Wwg, Aa^Fpa, Ss, Aa^Fpa, Aa^Fpa, Aa^Fpa, Aa^Fpa, Aa^Fpa, Aa^Fpa, Rra, Ha, Ha^Fpa, Ha, Ha, Aa^Fpa, Aa^Fpa, Aa^Fpa, Aa^Fpa, Aa^Fpa
Aa, Aa, Aa, Aa, Aa, Aa, Aa, Aa, Aa, Aa, Aa, Aa, Aa, Aa, Aa, Rra, Rra, Rra, Rra, Rra, Aa, Aa, Aa^Fpa, Aa^Fpa, Aa^Fpa, Aa^Fpa, Aa^Fpa, Aa^Fpa, Aa^Fpa, Aa^Fpa, Aa^Fpa, Aa^Fpa, Aa^Fpa, Aa^Fpa, Aa^Fpa, Rra, Aa^Fpa, Aa^Fpa, Aa^Fpa, Ai, Wwg, Wwg, Wwg, Wwg, Wwg, Ss, Aa^Fpa, Aa^Fpa, Aa^Feta, Aa^Fpa, Rra, Rra, Ha, Ha^Fpa, Ha, Aa^Fpa, Aa^Fpa, Aa^Fpa, Aa^Fpa, Aa^Fpa, Aa^Fpa
Aa^Fma, Aa, Aa, Aa, Aa, Aa, Aa, Aa, Aa, Aa, Aa, Aa, Aa, Aa, Aa^Vea, Rra, Aa, Aa, Aa, Aa, Aa, Aa, Aa, Aa^Fpa, Aa^Fpa, Aa^Fpa, Aa^Fpa, Aa^Fpa, Aa^Fpa, Aa^Fpa, Aa^Fpa, Aa^Fpa, Aa^Fpa, Aa^Vea, Aa^Fpa, Rra, Rra, Aa^Fpa, Wwg, Wwg, Cea, Cea, 3 Kea, Cea, Cea, Wwg, Aa^Fpa, Aa^Fpa, Aa^Fpa, Aa^Fpa, Rra, Rra, Ha^Fpa, Ha, Ha, Aa^Fpa, Aa^Fpa, Aa^Fpa, Aa^Fpa, Aa^Fpa, Aa^Fpa
Aa, Aa, Aa, Aa, Aa^Fda, Aa, Aa, Aa, Aa, Aa, Rra, Rra, Rra, Aa, Rra, Rra, Aa, Aa, Aa^Esa, Aa, Aa, Aa, Aa, Aa^Fpa, Aa^Fpa, Aa^Feta, Aa^Fpa, Aa^Fpa, Rra, Aa^Fpa, Aa, Aa^Fpa, Aa^Fpa, Aa^Fpa, Aa^Fpa, Aa^Fpa, Aa^Fpa, Rra, Rra, Wwg, Cea, Cea, Cea, Cea, Cea, Wwg, Aa^Fpa, Aa^Fpa, Rra, Rra, Ha, Ha, Ha, Ha, Aa^Fpa, Ha^Fpa, Aa^Fpa, Aa^Fpa, Aa^Fpa, Aa^Fpa, Aa^Fpa
Aa, Aa, Aa, Aa, Aa^Fma, Aa^Fda, Aa, Aa^Vea, Rra, Rra, Aa, Aa, Aa, Rra, Aa, Aa, Aa, Aa, Aa, Aa, Aa, Aa, Aa, Aa^Fpa, Aa^Fpa, Aa^Fpa, Aa^Fpa, Aa^Fpa, Aa^Vea, Rra, Aa^Fpa, Aa^Fpa, Aa^Fpa, Aa^Fpa, Ss, Aa^Fpa, Aa^Fpa, Rra, Wwg^Bsa\, Wwg, Rra, Cea, Aa^Fpa, Cea, Wwg, Wwg, Rra, Rra, Aa^Fpa, Aa^Vea, Aa^Fpa, Ha^Fpa, Aa^Fpa, Aa^Fpa, Aa^Fpa, Aa, Aa^Fpa, Aa^Fpa, Aa^Fpa, Aa^Fpa, Aa^Fpa
Aa, Aa, Aa, Aa, Aa, Aa, Aa^Fma, Aa, Rra, Aa, Aa, Aa, Aa, Aa, Aa, Aa, Aa, Aa, Aa, Aa, Aa, Aa, Aa, Aa^Fpa, Aa, Aa^Fpa, Aa^Fpa, Aa^Fpa, Aa^Fpa, Aa^Fpa, Aa^Fpa, Aa^Fpa, Aa^Fpa, Aa^Fpa, Ss, Ss, Aa^Fpa, Wwg, Wwg, Rra, Aa^Fpa, Rra, Rra, Aa^Fpa, Rra, Wwg^Bsa/, Aa^Fpa, Aa^Fpa, Aa^Fpa, Aa^Fpa, Aa^Fpa, Aa^Fpa, Aa^Fpa, Aa^Fpa, Aa^Fpa, Aa^Fpa, Aa^Fpa, Aa^Fpa, Aa^Fpa, Aa^Fpa, Aa^Fpa
Wwg, Wwg, Wwg, Aa, Aa, Aa, Aa, Aa, Aa, Rra, Rra, Aa, Aa, Aa, Aa, Aa, Wwg, Aa, Wwg, Aa, Aa^Fpa, Aa^Fpa, Aa^Fpa, Aa, Aa, Aa, Aa^Fpa, Aa^Es, Aa^Fpa, Aa^Fpa, Ss, Aa^Fpa, Aa^Fpa, Ss, Aa^Fpa, Aa^Fpa, Wwg, Wwg, Ss, Aa^Fpa, Aa^Feta, Aa^Fpa, Aa^Fpa, Rra, Aa^Fpa, Wwg, Ai, Aa^Fpa, Aa^Fpa, Aa^Fpa, Aa^Fpa, Aa^Fpa, Aa^Fpa, Aa^Fpa, Aa^Fpa, Aa^Fpa, Aa^Fpa, Aa^Fpa, Aa^Fpa, Aa^Fpa, Aa^Fpa
Aa, Aa, Aa, Wwg, Aa, Aa, Aa, Aa, Aa, Aa, Aa, Rra, Rra, Ai, Wwg, Wwg, Wwg, Wwg, Wwg, Wwg, Aa^Fpa, Aa^Fpa, Aa^Fpa, Aa^Fpa, Aa, Aa^Fpa, Aa^Fpa, Aa^Fpa, Aa^Fpa, Aa^Fpa, Aa^Fpa, Aa^Fpa, Wwg, Aa^Fpa, Wwg, Wwg, Aa^Fpa, Aa^Fpa, Aa^Fpa, Aa^Fpa, Aa^Fpa, Aa^Fpa, Aa^Fpa, Rra, Aa^Fpa, Wwg, Wwg, Aa^Fpa, Aa^Fpa, Aa^Fpa, Aa^Fpa, Aa^Fpa, Aa^Fpa, Aa^Fpa, Aa^Fpa, Aa^Vea, Aa^Fpa, Aa^Feta, Aa^Fpa, Aa^Fpa, Aa^Fpa
Aa^Fma, Aa^Fda, Aa, Wwg, Wwg, Wwg, Ai, Aa, Aa, Aa^Fma, Aa^Fda, Aa^Fma, Aa, Ww^Bsa\, Rra, Aa, Aa, Aa, Aa, Wwg, Wwg, Wwg, Wwg, Aa^Fpa, Wwg, Aa, Wwg, Aa^Fpa, Wwg, Aa^Fpa, Wwg, Wwg, Aa^Fpa, Wwg, Aa^Fpa, Aa^Fpa, Ss, Ss, Aa^Fpa, Aa^Fpa, Aa^Fpa, Aa^Es, Aa^Fpa, Rra, Aa^Fpa, Aa^Fpa, Aa^Fpa, Wwg, Wwg, Aa^Fpa, Aa^Fpa, Aa^Fpa, Aa^Fpa, Aa^Fpa, Aa^Fpa, Aa^Fpa, Aa^Fpa, Aa^Fpa, Aa^Fpa, Aa^Fpa, Aa^Fpa
Aa^Fma, Aa^Fma, Aa, Aa, Aa^Fma, Aa, Aa, Ai, Aa, Aa^Fma, Aa^Fma, Aa, Ai, Wwg, Cea, Rra, Rra, Aa, Aa, Aa, Aa, Aa, Ai, Wwg, Ai, Wwg, Wwg, Wwg, Wwg, Wwg, Ss, Wwg, Aa^Fpa, Aa^Fpa, Aa^Fpa, Aa^Fpa, Aa^Fpa, Aa^Fpa, Aa^Fpa, Aa^Fpa, Aa^Fpa, Aa^Vea, Rra, Rra, Rra, Aa^Fpa, Aa^Fpa, Aa^Fpa, Wwg, Aa^Fpa, Aa^Fpa, Aa^Fpa, Aa, Aa^Fpa, Aa^Fpa, Aa^Fpa, Aa^Fpa, Aa^Fpa, Aa^Fpa, Aa^Fpa, Aa^Fpa
Aa, Aa^Fma, Aa, Aa^Fma, Aa^Fma, Aa, Aa, Wwg, Wwg, Wwg, Wwg, Wwg, Cea, Cea, 4 Kea, Cea, Rra, Aa, Aa, Aa, Aa, Aa, Aa, Ai, Aa, Aa, Aa^Esa, Aa, Aa, Aa^Fpa, Aa, Aa^Fpa, Aa^Fpa, Aa^Vea, Rra, Aa^Fpa, Rra, Aa^Fpa, Rra, Rra, Rra, Rra, Aa^Fpa, Aa^Fpa, Aa^Fpa, Rra, Cea, Aa^Fpa, Wwg, Aa^Fpa, Aa^Fpa, Aa^Fpa, Aa^Fpa, Aa, Aa^Fpa, Aa^Fpa, Aa^Es, Aa^Fpa, Aa^Fpa, Aa^Fpa, Aa^Fpa
Rra, Rra, Rra, Rra, Rra, Aa^Vea, Aa, Aa, Aa, Aa, Aa, Aa, Cea, Cea, Cea, Cea, Rra, Rra, Rra, Rra, Rra, Aa, Aa, Aa, Aa, Aa, Aa, Aa, Aa, Aa^Fpa, Rra, Aa, Rra, Rra, Aa^Fpa, Rra, Aa^Fpa, Rra, Aa^Fpa, Aa^Fpa, Aa^Fpa, Aa^Fpa, Aa^Fpa, Aa^Fpa, Aa^Fpa, Cea, Cea, Cea, Cea, Wwg, Aa^Fpa, Aa^Fpa, Aa^Fpa, Aa^Fpa, Aa^Fpa, Aa^Fpa, Aa^Fpa, Aa^Fpa, Aa^Vea, Aa^Fpa, Aa^Fpa
Aa, Aa, Aa, Aa, Aa, Rra, Rra, Aa, Rra, Aa, Rra, Aa, Rra, Rra, Rra, Rra, Aa, Aa, Aa, Aa, Aa, Rra, Rra, Rra, Rra, Rra, Rra, Aa, Rra, Rra, Aa^Fpa, Rra, Aa^Fpa, Aa^Fpa, Aa^Fpa, Aa^Fpa, Aa^Fpa, Aa^Fpa, Aa^Vea, Aa^Fpa, Aa^Fpa, Aa^Fpa, Aa^Fpa, Aa^Fpa, Aa^Fpa, Cea, 1 Kea, 2 Kea, Cea, Wwg, Aa^Fpa, Aa^Fpa, Aa^Fpa, Aa^Fpa, Aa^Feta, Aa^Fpa, Aa^Fpa, Aa^Fpa, Aa^Fpa, Aa^Fpa, Aa^Fpa
Aa, Aa, Aa, Aa, Aa, Aa, Aa, Rra, Aa, Rra, Aa, Rra, Aa, Aa^Vea, Aa, Aa, Aa, Aa, Aa, Aa, Aa, Aa, Aa, Aa, Aa, Aa, Aa, Rra, Aa, Aa, Aa, Aa^Fpa, Aa^Fpa, Aa^Fpa, Aa^Fpa, Aa^Feta, Aa^Fpa, Aa^Fpa, Aa^Fpa, Aa^Fpa, Aa^Fpa, Aa^Fpa, Aa^Fpa, Aa^Fpa, Aa^Fpa, Cea, Cea, Cea, Aa^Fpa, Wwg, Wwg, Aa^Fpa, Aa^Fpa, Aa^Fpa, Aa^Fpa, Aa^Fpa, Aa^Fpa, Aa^Fpa, Aa^Fpa, Aa^Fpa, Aa^Fpa
Aa, Aa, Aa, Aa, Aa, Aa, Aa, Aa, Aa, Aa, Aa, Aa, Aa, Aa, Aa, Aa, Aa, Aa, Aa, Aa, Aa, Aa, Aa, Aa, Aa, Aa, Aa, Aa, Aa, Aa, Aa, Aa, Aa^Fpa, Aa^Fpa, Aa^Fpa, Aa^Fpa, Aa^Fpa, Aa^Fpa, Aa^Fpa, Aa^Fpa, Aa^Fpa, Aa^Fpa, Aa^Fpa, Aa^Fpa, Aa^Fpa, Aa^Fpa, Aa^Fpa, Rra, Aa^Fpa, Aa^Fpa, Ww, Aa^Fpa, Aa^Fpa, Aa^Fpa, Aa^Fpa, Aa^Fpa, Aa^Fpa, Aa, Aa^Fpa, Aa^Fpa, Aa^Fpa
