Aa, Aa, Aa^Fda, Aa^Fda, Aa^Fda, Ss, Ss, Ss, Ss, Ss, Ss, Ss, Ss, Ss, Ss, Ss, Ss, Ss, Ss, Ss, Ss, Ss, Coa, Coa, Coa, Ss, Aa^Fpa, Hh, Ha, Ha, Xue, Xue, Xue, Xu, Xue, Xue, Xue
Aa, Aa, Aa, Aa, Re, Aa^Fda, Ss, Ss, Ss, Aa^Fpa, Aa^Fpa, Ss, Ss^Vhs, Ss, Aa^Fpa, Aa^Fpa, Aa^Fpa, Ss^Vhs, Ss, Ss, Ss, Ss, Coa, Coa, Coa, Ss, Aa^Fpa, Aa^Fpa, Aa^Fpa, Ha, Ha, Xue, Xue, Xue, Xue, Xue, Ha
Aa^Fda, Aa, Aa^Fma, Aa^Fma, Re, Ss, Ss, Ss, Ss, Ss, Aa^Fpa, Aa^Fpa, Rb, Ss, Ss, Aa^Fpa, Aa^Fpa, Aa^Fpa, Aa^Fpa, Ss, Ss, Ss, Coa, 3 Koa, Coa, Ss, Aa^Fpa, Aa^Fpa, Aa^Fpa, Ha, Ss, Ha, Sm^Es, Xuf, Ha^Es, Ha, Ha
Aa^Fda, Aa, Aa, Aa, Re, Re, Re, Ss^Vhs, Ss, Ss, Re, Aa^Fpa, Aa^Fpa, Rb, Ss, Aa^Fpa, Aa^Fpa, Aa^Fpa, Ss, Ss, Ss, Ss, Rb, Rb, Ss, Ss, Aa^Fpa, Aa^Feth, Aa^Fpa, Ss, Ss, Ss, Rra, Rb^Es, Rra, Rra, Rra
Aa, Aa, Aa, Aa^Vht, Aa, Aa^Fma, Re, Re, Aa, Re, Re, Ss, Ss, Rb, Ss, Ss, Aa^Fpa, Aa^Fpa, Aa^Fpa, Ss^Vht, Ss, Ss, Rb, Rb, Ss, Ss, Ss, Aa^Fpa, Aa^Fpa, Ss, Ss, Ss, Rra, Rb, Rb, Rra, Rra
Aa, Aa, Cea, Aa, Aa, Aa, Aa, Aa^Fpa, Aa, Aa, Re, Re, Re, Ss, Rb, Ss, Rb, Aa^Fpa, Rb, Rb, Ss, Ss, Aa^Fpa, Rb, Rb, Ss, Ss, Aa^Fpa, Ss, Ss, Ss, Ss, Ss, Sm, Rb, Ds, Rra
Aa, Cea, 2 Kea, Cea, Aa, Aa^Fma, Aa^Fma, Aa, Aa^Vht, Aa^Fpa, Aa, Aa, Aa, Aa^Fpa, Aa^Fpa, Rb, Aa^Fpa, Rb, Ss, Ss, Ss, Ss, Aa^Fpa, Aa^Fpa, Aa^Fpa, Rb, Ss, Ss, Ss, Ss, Rb, Ss, Rb, Rb, Ds, Ds, Ds
Aa, Aa, Aa, Cea, Aa, Aa, Aa, Aa, Aa^Fpa, Aa^Fpa, Aa, Aa^Fpa, Re, Aa^Fpa, Aa^Fpa, Aa^Fpa, Aa^Fpa, Rb, Rb, Ss^Vhs, Rb, Aa^Fpa, Rb, Rb, Rb, Rb, Rb, Rb, Rb, Rb, Rb, Rb, Rb, Ds, Ds, Rra^Vka, Rra
Aa, Aa, 1 Kea, Cea, Aa, Aa, Aa^Fma, Aa^Fma, Aa^Fpa, Aa, Aa, Aa^Fpa, Re, Aa^Fpa, Ss^Vhs, Aa^Fpa, Aa^Fpa, Rb, Ss, Rb, Aa^Fpa, Rb, Ss, Ss^Vhs, Aa^Fpa, Ss, Aa^Fpa, Rb, Aa^Fpa, Aa^Fpa, Aa^Fpa, Sm, Rb, Rb, Rb, Rra, Rra
Aa, Cea, Cea, Cea, Aa^Fda, Aa, Aa^Vht, Re, Re, Aa, Aa^Fpa, Re, Ss, Rb, Ss, Aa^Fpa, Aa^Fpa, Aa^Fpa, Ss, Ss, Rb, Rb, Ss, Ss, Aa^Fpa, Aa^Fpa, Ss, Aa^Fpa, Aa^Fpa, Ss, Coa, Coa, Rb, Rb, Rra, Rra, Ds
Aa^Fda, Ss, Aa^Fda, Aa^Fda, Aa^Fda, Aa^Fda, Aa, Re, Sm, Re, Aa^Fpa, Aa^Fpa, Ss, Rb, Sm, Sm, Aa^Fpa, Aa^Fpa, Rb, Rb, Ss, Aa^Fpa, Ss, Aa^Fpa, Aa^Fpa, Aa^Fpa, Aa^Fpa, Ss, Ss, Coa, Coa, 4 Koa, Rb, Rb, Rra^Vka, Rra, Ds
Aa^Fda, Ss, Aa^Fda, Aa^Fda, Re, Re, Sm, Sm, Aa^Fpa, Sm, Sm, Rb, Ss, Rb, Rb, Ss, Aa^Fpa, Aa^Fpa, Rb, Rb, Ss, Ss, Ss, Ss, Aa^Fpa, Aa^Fpa, Aa^Fpa, Ss, Ss, Ss, Ss, Coa, Rb, Rb, Ds, Ds, Ds
Aa^Fda, Ss, Ss, Aa^Fda, Aa^Fda, Re, Aa^Fpa, Aa^Fpa, Aa^Fpa, Sm, Rb, Rb, Rb, Ss, Ss, Rb, Rb, Rb, Aa^Fpa, Aa^Fpa, Ss, Ss, Sm, Ss^Vhs, Ss, Aa^Fpa, Ss, Ss, Ss^Vhs, Ss, Ss, Ds, Ds, Rb, Rra, Ds, Ds
Aa^Fda, Ss, Ss, Ss^Vhs, Ss, Re, Rb, Aa^Fpa, Rb, Rb, Rb, Sm, Rb, Ss, Ss, Ss, Ss, Aa^Fpa, Aa^Fpa, Aa^Fpa, Ss, Ss, Sm, Sm, Ss, Ss, Ss, Ss, Ss, Ss, Ds, Ds, Rb, Rb, Rra, Rra, Ds
Aa, Aa, Ss, Ss, Ss, Ss, Ss, Rb, Sm, Sm, Aa^Fpa, Sm, Rb, Ss, Ss^Vht, Ss, Ss, Ss, Ss, Ss, Ss, Sm, Ss, Ss, Aa^Fpa, Aa^Fpa, Rra, Ss, Ss, Ss, Ds, Ds, Rb, Rra, Rra, Ds, Ds
Aa, Re, Ss, Ss, Ss, Aa^Fda, Aa^Fda, Sm, Sm, Aa^Fpa, Aa^Fpa, Sm, Sm, Rb, Rb, Ss, Rb, Ss, Rb, Ss, Ss, Ss, Aa^Fpa, Aa^Fpa, Aa^Fpa, Aa^Fpa, Rra, Rra, Rra, Ds, Rra, Rra, Rb, Rra^Vka, Rra, Ds, Rra
Re, Re, Re, Sm, Sm, Aa^Fda, Aa^Fda, Sm, Rb, Sm, Aa^Fpa, Aa^Fpa, Aa^Fpa, Sm, Sm, Rb, Sm, Rb, Rb, Rb, Rb, Rb, Rb, Rb, Rb, Rra, Rra, Rra, Rra, Rra, Rra, Rra, Rra, Rb, Rra, Rra, Rra
Ss, Sm, Sm, Sm, Ss, Sm, Aa^Fda, Aa^Fda, Ss, Sm, Sm, Rb, Aa^Fpa, Sm, Sm, Sm, Ss, Sm, Sm, Sm^Vhs, Aa^Fpa, Aa^Fpa, Aa^Fpa, Ss, Rra, Rb, Rb, Rra, Rb, Rb, Rb, Rra, Rb, Rb, Rra, Rra, Rra
Ss, Ss^Vhs, Rb, Sm, Sm, Sm, Rb, Sm, Ss^Vhs, Ss, Sm, Rb, Sm, Aa^Fpa, Sm, Ss, Sm, Ss, Sm, Sm, Sm, Aa^Fpa, Aa^Fpa, Ss, Ss, Rra, Rra, Rb, Coa^Edb, Coa^Edb, Coa^Edb, Rb, Rra, Rra, Rra, Rra, Ds
Ss, Ss, Sm, Aa^Fda, Aa^Fda, Sm, Rb, Sm, Sm, Ss, Rb, Rb, Sm, Sm, Sm, Sm, Sm, Sm, Sm, Ss, Aa^Fpa, Sm, Sm, Ss, Ss, Rra, Rra, Rb, Coa^Edb, Coa^Edb, Coa^Edb, Rb, Rra, Ds, Ds, Ds, Sm
Ss, Ss, Ss, Ss, Ss, Ss, Ss, Sm, Sm, Sm, Rb, Ss, Sm, Aa^Fpa, Aa^Fpa, Sm, Ss^Vhs, Sm, Sm, Aa^Fpa, Aa^Fpa, Aa^Fpa, Sm, Sm, Ss^Vhs, Rra, Rra, Rb, Rb, Coa^Edb, Rb, Rb, Rra, Ds, Ds, Sm, Sm
Ss, Ss, Aa^Fda, Ss, Sm, Ss^Vhs, Ss, Ss, Sm, Rb, Sm, Ss, Ss^Vhs, Aa^Fpa, Aa^Fpa, Sm, Sm, Ss, Ss, Aa^Fpa, Aa^Fpa, Aa^Fpa, Aa^Fpa, Sm, Sm, Ss, Ds, Rra, Ds, Rb, Rra, Rra, Rra, Rra, Sm, Sm, Sm
Ss, Sm, Ss, Aa^Fda, Aa, Ss, Ss, Ss, Rb, Rb, Ss, Ss, Sm, Aa^Fpa, Aa^Fpa, Aa^Fpa, Aa^Fpa, Sm, Sm, Ss, Aa^Fpa, Aa^Fpa, Aa^Fpa, Sm, Sm, Ss, Ss, Ds, Ds, Rra, Rra, Rra, Sm, Rra, Sm, Sm, Sm
Ss, Ss, Aa^Fda, Aa^Fda, Aa^Fda, Aa, Aa, Rb, Ss, Sm, Ss, Ss, Sm, Aa^Fpa, Aa^Fpa, Aa^Feth, Aa^Fpa, Sm, Sm, Ss, Ss, Aa^Fpa, Sm, Sm, Ss, Sm, Ss, Ds, Sm, Sm, Sm, Sm, Sm, Sm, Sm, Sm, Sm
Ss, Ss, Aa^Fda, Aa^Fda, Aa^Fda, Aa^Fda, Re, Ss, Ss, Sm, Sm, Sm, Ss, Sm, Sm, Aa^Fpa, Sm, Aa^Fpa, Sm, Sm, Coa, Coa, Ss, Sm, Sm, Ss, Sm, Ss, Sm, Sm, Ss, Sm, Ss, Sm, Sm, Sm, Sm
Ss, Aa^Fda, Ss, Ss, Ss, Ss, Re, Ss, Sm, Sm, Ss, Sm, Sm, Sm, Ss, Sm, Ss, Sm, Sm, Ss, Sm, 5 Koa, Ss, Sm, Ss, Ss, Sm, Ss, Ss, Sm, Sm, Ss, Sm, Sm, Sm, Sm, Sm
Ss, Ss, Ss, Ss, Ss, Ss, Re, Ss, Ss, Ss, Ss, Ss, Ss, Sm, Sm, Ss, Ss, Ss, Ss, Ss, Sm, Sm, Sm, Ss, Ss, Sm, Sm, Sm, Ss, Sm, Sm, Sm, Ss, Sm, Sm, Sm, Sm
