Aa, Aa, Aa^Fda, Aa^Fda, Aa^Fma, Ss, Ss, Ss, Ai, Ai, Ss, Ss, Ss, Ss, Ss, Ss, Ss, Ss, Ss, Ss, Ss, Ss, Coa, Coa, Coa, Ai, Aa^Fpa, Aa, Ha, Ha, Xue, Xue, Xue, Xu, Xue, Xue, Xue
Aa, Aa, Aa^Esa, Aa, Re, Aa^Fma, Ss, Ss, Ai, Aa^Fpa, Aa^Fpa, Ss, Ss^Vhs, Ss, Aa^Fpa, Aa^Fpa, Aa^Fpa, Ss^Vhs, Ss, Ss, Ss, Ss, Coa, Coa, Coa, Ai, Aa^Fpa, Aa^Fpa, Aa^Fpa, Ha, Ha, Xue, Xue, Xue, Xue, Xue, Ha
Aa^Fda, Aa, Aa^Fma, Aa^Fma, Re, Ss, Ss, Ai, Ss, Ai, Aa^Fma, Aa^Fpa, Rb, Ai, Ai, Aa^Fpa, Aa^Fdw, Aa^Fpa, Aa^Fpa, Ss^Edt, Ai, Ai, Coa, 3 Koa, Coa^Es, Ss, Aa^Fma, Aa^Fma, Aa^Fpa, Ha, Sm^Ewl, Ha, Sm, Uue, Ha, Ha, Ha
Aa^Fda, Aa, Aa^Esa, Aa, Re, Re, Rb, Ss^Vhs, Ss, Ai, Re, Aa^Fma, Aa^Fma, Rb, Ai, Aa^Fpa, Aa^Fma, Aa^Fpa, Ss^Edt, Ss^Edt, Ss, Ai, Re^Esa, Re, Ss, Ss, Aa^Fma, Aa^Feth, Aa^Fma, Ai, Ss, Sm, Rra, Rra, Dd^Do, Ha, Ha
Aa, Aa, Aa, Aa^Vht, Aa, Aa^Fma, Rb, Rb, Aa, Re, Re, Ss, Ss, Rb, Ss, Ai, Aa^Fpa, Aa^Fma, Aa^Fpa, Ss^Vht, Ss, Ai, Re, Re, Ss^Ewl, Ss, Ss, Aa^Fpa, Aa^Fma, Ai, Ss, Sm, Rra, Rra, Rra, Ha, Ha
Aa, Aa, Cea, Aa, Cea, Aa, Aa^Esa, Aa^Fpa, Aa, Aa, Re, Rb, Rb, Ss, Rb, Ai, Rb, Aa^Fpa, Rb, Rb, Ss, Ss, Aa^Fma, Rb, Rb, Ss, Ss, Aa^Fpa, Ai, Ss, Ss, Ss, Ss, Sm, Rra, Ha, Ha
Aa, Aa, 2 Kea, Cea, Aa, Aa^Fma, Aa^Fma, Aa, Aa^Vht, Aa^Fpa, Aa, Aa, Aa, Aa^Fpa, Aa^Fpa, Rb, Aa^Fpa, Rb, Ss, Ss, Ss, Ss, Aa^Fma, Aa^Fpa, Aa^Fpa, Rb, Ai, Ai, Ai, Ss, Re^Esa, Ss, Rra, Rra, Ha, Ha, Ha
Aa, Aa, Aa, Aa, Aa, Aa^Esa, Aa, Aa, Aa^Fpa, Aa^Fpa, Aa, Aa^Fpa, Rb, Aa^Fpa, Aa^Fpa, Aa^Fma, Aa^Fpa, Rb^Esa, Rb, Ss^Vhs, Rb, Aa^Fma, Rb, Rb, Rb, Rb^Esa, Ss^Bw\r, Re, Re, Re^Esa, Re, Re^Esa, Rra, Ha, Ha, Aa^Vka, Ha
Aa, Aa, 1 Kea, Cea, Cea, Aa, Aa^Fma, Aa^Fma, Aa^Fpa, Aa^Esa, Aa, Aa^Fpa, Rb, Aa^Fpa, Ss^Vhs, Aa^Fma, Aa^Fma, Rb^Esa, Ai, Rb, Aa^Fpa, Re, Ss, Ss^Vhs, Rb^Fp, Ss, Aa^Fma, Aa^Fpa, Aa^Fma, Aa^Fpa, Aa^Fpa, Rra^Es, Rra, Aa, Aa^Dc, Aa^Esa, Aa
Aa^Fda, Aa^Fda, Aa^Fda, Cea, Aa^Fda, Aa, Aa^Vht, Rb, Rb, Aa, Aa^Fpa, Rb, Ss, Rb, Ss, Aa^Fpa, Aa^Fma, Aa^Fma, Ai, Ai, Re, Re, Ss, Ss, Aa^Fma, Aa^Fma, Ss, Aa^Fma, Aa^Fpa, Ss, Cd, Cd, Rra, Aa, Aa, Aa^Esa, Aa
Aa^Fda, Aa^Fda, Aa^Fda, Aa^Fda, Aa^Fma, Aa^Fda, Aa, Rb, Ai, Rb, Aa^Fpa, Aa^Fmw, Ss, Rb, Ai, Ai, Aa^Fpa, Aa^Fpa, Rb, Ss^Bw/r, Ss, Aa^Fpa, Ss, Aa^Fpa, Aa^Fpa, Aa^Fma, Aa^Fpa, Ss, Ss, Cdr^Es, Cdr, 4 Kdr, Rra, Aa^Esa, Rra^Vka, Ha, Ha
Ss, Ss, Aa^Fda, Aa^Fma, Re, Re, Ai, Ai, Aa^Fpa, Ai, Ai, Re, Ss, Rb, Rb, Ss, Aa^Fma, Aa^Fpa, Rb, Rb^Esa, Ai, Ss, Ss, Ss, Aa^Fpa, Aa^Fma, Aa^Fpa, Ss, Ss, Ss, Ss, Cd, Rra^Es, Rra^Es, Ha, Ha, Ha
Aa^Fma, Ss, Ss, Aa^Fma, Aa^Fma, Re, Aa^Fpa, Aa^Fma, Aa^Fpa, Ai, Re, Re, Re^Esa, Ss, Ss, Rb, Rb, Rb, Aa^Fpa, Aa^Fma, Ai, Ss, Sm^Ewl, Ss^Vhs, Ss, Aa^Fpa, Ss, Ss, Ss^Vhs, Ss, Ss, Rra, Rra^Es, Rra, Ha, Ha, Ha
Aa^Fma, Ss, Ss, Ss^Vhs, Ss, Re, Rb, Aa^Fma, Rb, Rb, Sm^Bw|r, Sm, Re, Ss, Ss, Ss, Ss, Aa^Fpa, Aa^Fma, Aa^Fma, Ai, Ai, Sm, Sm, Ss, Ss, Ss, Ss, Ss, Ss, Aa, Aa, Aa, Rra, Ha, Ha, Ha
Aa, Aa, Ss, Ss, Ss, Ss, Ss, Rb, Sm, Sm, Aa^Fpa, Sm, Rb, Ss, Ss^Vht, Ss, Ss, Ss, Ss, Ss, Ss, Sm, Ss, Ss, Aa^Fdw, Aa^Fpa, Aa^Esa, Ss, Ss, Ss, Aa, Aa, Rra, Rra, Ha, Ha, Ha
Aa, Re, Ss, Ss, Ss, Aa^Fda, Aa^Fma, Sm^Edt, Sm, Aa^Fma, Aa^Fma, Sm, Sm, Rb, Ss^Bw\r, Ss, Re, Ss, Rb, Ss, Ai, Ai, Aa^Fpa, Aa^Fma, Aa^Fpa, Aa^Fma, Aa, Aa, Aa^Esa, Aa, Aa^Esa, Aa, Rra, Rra^Vka, Ha, Ha, Ha
Re, Re, Re, Sm, Sm, Aa^Fma, Aa^Fda, Sm, Rb, Ai, Aa^Fpa, Aa^Fma, Aa^Fma, Sm, Sm^Edt, Re, Sm, Rb, Re, Re^Esa, Re, Re, Re^Esa, Re^Esa, Rra, Aa, Aa^Esa, Dd^Do, Aa, Aa^Esa, Aa, Rra, Ha, Ha, Ha, Ha, Ha
Ss, Sm, Ss^Vhs, Sm, Ss, Sm, Aa^Fma, Aa^Fma, Ss, Ai, Sm, Rb^Em, Aa^Fma, Sm, Sm, Sm^Ewl, Ss, Sm, Sm, Sm^Vhs, Aa^Fma, Aa^Fma, Aa^Fma, Ss, Aa, Rra, Rra, Aa, Rra, Rra, Rra^Es, Rra^Es, Ha, Ha, Ha, Ha, Aa
Ss, Ss^Esa, Rb^Esa, Sm^Esa, Sm, Sm, Rb^Esa, Ai, Ss^Vhs, Ss, Sm, Rb, Sm^Ewl, Aa^Fpa, Ai, Ss, Sm^Ewl, Ss, Ai, Ai, Ai, Aa^Fpa, Aa^Fma, Ss, Ss, Aa^Esa, Aa^Esa, Rra^Es, Cdr^Es, Cdr, Cdr^Es, Rra^Dr, Ha, Ha, Aa^Dc, Aa, Aa
Ai, Ss, Sm, Aa^Fma, Aa^Fda, Sm, Rb, Ai, Ai, Ss, Rb, Rb, Sm, Ai, Ai, Sm, Sm, Sm, Ai, Ss, Aa^Fma, Ai, Ai, Ss, Ss, Aa, Aa, Rra, Cdr^Es, Cdr^Es, Cdr, Rra^Es, Ha, Aa^Esa, Aa, Aa^Esa, Ss
Ai, Ai, Ai, Ai, Ss, Ss, Ss, Ai, Ai, Ai, Re, Ss, Sm, Aa^Fpa, Aa^Fpa, Ai, Ss^Vhs, Sm, Sm, Aa^Fpa, Aa^Fma, Aa^Fpa, Sm, Sm, Ss^Vhs, Aa, Aa, Rra, Rra^Es, Cdr^Es, Rra, Rra^Es, Aa^Esa, Aa^Esa, Aa, Ss, Sm
Ai, Ai, Aa^Fda, Ai, Sm, Ss^Vhs, Ss, Ai, Sm, Re, Sm, Ss, Ss^Vhs, Aa^Fpa, Aa^Fpa, Ai, Ai, Ss, Ss, Aa^Fpa, Aa^Fma, Aa^Fpa, Aa^Fma, Sm, Sm, Ss, Aa, Aa^Esa, Aa^Esa, Rra, Aa, Aa, Aa, Aa, Ss, Ss, Sm
Ai, Ai, Ai, Aa^Fma, Aa^Esa, Sm, Ss, Ss, Sm^Bw/r, Re, Ss, Ss, Sm, Aa^Fpa, Aa^Fma, Aa^Fma, Aa^Fpa, Sm, Sm, Ss, Aa^Fpa, Re^Esa, Aa^Fma, Sm^Ewl, Sm, Ss, Ss, Aa, Aa, Aa^Esa, Aa, Aa, Ss, Aa, Ss, Sm, Sm
Ss, Ss, Aa^Fma, Aa^Fda, Aa^Fma, Aa^Esa, Aa, Rb, Ss, Sm, Ss, Ss, Sm, Aa^Fpa, Aa^Fma, Aa^Feth, Aa^Fma, Sm, Sm, Ss, Ss, Re, Sm, Sm, Ss, Sm, Ss, Aa, Ss, Ss, Ss, Ss, Sm, Ss, Sm, Sm, Sm^Ewl
Ss, Ss, Aa^Fda, Aa^Fma, Aa^Fda, Aa^Fma, Rb, Ss, Ss, Sm, Sm, Sm, Ai, Sm, Ai, Aa^Fma, Sm, Aa^Fpa, Sm, Sm, Coa, Coa^Es, Coa, Ai, Ai, Ss, Sm, Ss, Sm, Sm, Ss, Sm, Ss, Sm, Sm, Sm^Ewf, Sm^Ewl
Ss, Aa^Fda, Ss, Ss, Ss, Ss, Rb, Ss, Sm, Sm, Ai, Sm, Ai, Ai, Ai, Sm, Ai, Sm, Sm, Ss, Sm, 5 Koa, Ai, Ai, Ss, Ss, Sm, Ss, Ss, Sm, Sm, Ss, Sm, Sm, Sm^Ewl, Sm^Ewl, Sm^Ewl
Ss, Ss, Ss, Ss, Ss, Ss, Rb, Ss, Ss, Ss, Ss, Ai, Ai, Ai, Ai, Ai, Ai, Ai, Ss, Ss, Sm, Coa, Ai, Ai, Ai, Ai, Sm, Sm, Ss, Sm, Sm, Sm, Sm, Sm^Ewl, Sm^Ewl, Sm^Ewl, Sm
