Hh, Hh, Hh, Gg, Gg, Gg, Gg, Gg, Gg, Gg, Gll^Fp, Gll^Fp, Gll^Fp, Gll^Fp, Gll^Fp, Gll^Fp, Gll^Fp, Gll^Fp, Gll^Fp, Gll^Fp, Gll^Fp, Gll^Fp, Gll^Fp, Gll^Fp, Gll^Fp, Gll^Fp, Gll^Fp, Gll^Fp, Gll^Fp, Gll^Fp, Gll^Fp, Ww, Gll^Fp, Gll^Fp, Gll^Fp, Gll^Fp, Gll^Fp, Gll^Fp, Gll^Fp, Gll^Fp, Gll^Fp, Gll^Fp, Gll^Fp, Gll^Fp, Gll^Fp, Gll^Fp, Hh, Hh, Hh, Mm, Mm, Mm, Mm, Hh, Hh, Hh, Rp, Rp, Hh, Hh, Hh
Hh, Hh, Hh, Hh, Hh, Gg, Gg, Gg, Gg, Gg, Gg, Gll^Fp, Gll^Fp, Gll^Fp, Gll^Fp, Gll^Fp, Gll^Fp, Gll^Fp, Gll^Fp, Gll^Fp, Gll^Fp, Gll^Fp, Gll^Fp, Gg^Fet, Gll^Fp, Gll^Fp, Gll^Fp, Gll^Fp, Gll^Fp, Gll^Fp, Ww, Ww, Gll^Fp, Gll^Fp, Gll^Fp, Gll^Fp, Gll^Fp, Gll^Fp, Gll^Fp, Gll^Fp, Gll^Fp, Gll^Fp, Gll^Fp, Gll^Fp, Gll^Fp, Hh, Hh, Hh^Fp, Mm, Mm, Mm, Mm, Mm, Hh, Gg^Ve, Hh, Rp, Hh, Hh, Mm, Mm
Re, Hh, Hh, Hh, Hh, Gg, Gg, Gg, Hh, Gg, Gg, Gg, Gll^Fp, Gll^Fp, Gll^Fp, Gg^Ve, Gll^Fp, Gll^Fp, Gll^Fp, Gll^Fp, Gll^Fp, Gll^Fp, Gll^Fp, Gll^Fp, Gll^Fp, Ww, Ww, Ww, Ww, Ww, Gll^Fp, Gll^Fp, Gll^Fp, Gll^Fp, Gll^Fp, Gll^Fp, Gll^Fp, Gll^Fp, Gll^Fp, Gg^Ve, Gll^Fp, Gll^Fp, Gg, Gll^Fp, Gll^Fp, Hh^Fp, Hh^Fp, Mm, Hh, Mm, Hh, Mm, Hh^Fp, Hh, Hh, Rp, Hh, Hh, Mm, Mm, Mm
Hh, Re, Hh, Hh, Gg, Hh, Gg, Gg, Gg, Hh, Gg, Gg, Gg, Gll^Fp, Gll^Fp, Gll^Fp, Gll^Fp, Gll^Fp, Gg, Gll^Fp, Gll^Fp, Gll^Fp, Gll^Fp, Gg, Ww, Ww, Gll^Fp, Ss, Ss, Ss, Gll^Fp, Gg^Fet, Gll^Fp, Gll^Fp, Gll^Fp, Gll^Fp, Gll^Fp, Ss, Gll^Fp, Gll^Fp, Gll^Fp, Gll^Fp, Gll^Fp, Gll^Fp, Gll^Fp, Hh, Gll^Fp, Hh, Hh, Hh, Hh, Hh, Hh^Fp, Hh, Rp, Rp, Hh, Hh, Mm, Mm, Mm
Hh, Re, Re, Hh, Hh, Gg, Gg, Gg, Gg, Gg, Gg, Gg, Gg, Gll^Fp, Gll^Fp, Gll^Fp, Gg^Fet, Gll^Fp, Gll^Fp, Gll^Fp, Gll^Fp, Gll^Fp, Ww, Gll^Fp, Ww, Gll^Fp, Gll^Fp, Gll^Fp, Gg^Ve, Gll^Fp, Gll^Fp, Gll^Fp, Ss, Gll^Fp, Gll^Fp, Gll^Fp, Ss, Ss, Gll^Fp, Gll^Fp, Gll^Fp, Gll^Fp, Gll^Fp, Gll^Fp, Gll^Fp, Gll^Fp, Gll^Fp, Hh, Gll^Fp, Gll^Fp, Gll^Fp, Gll^Fp, Rp, Rp, Gll^Fp, Hh, Gll^Fp, Mm, Hh, Hh, Mm
Hh, Hh, Ce, Re, Re, Ce, Gg, Gg, Rd^Gvs, Rd^Gvs, Gg, Gg, Gg, Gll^Fp, Gll^Fp, Gll^Fp, Gll^Fp, Gll^Fp, Gll^Fp, Gll^Fp, Gll^Fp, Ww, Cv^Fet, Ww, Ww, Ww, Ww, Gll^Fp, Gll^Fp, Gll^Fp, Gll^Fp, Ss, Ww, Gll^Fp, Ww, Gll^Fp, Ww, Ww, Ww, Ss, Ss, Gll^Fp, Gg, Gll^Fp, Gll^Fp, Gg^Fet, Gll^Fp, Gll^Fp, Gll^Fp, Gll^Fp, Rp, Rp, Gll^Fp, Gg^Ve, Gll^Fp, Gll^Fp, Gll^Fp, Hh, Hh, Hh^Fp, Mm
Hh, 6 Ke, Ce, Ce, Re, Ce, Gg, Gg, Rd^Gvs, Rd^Gvs, Rd^Gvs, Gg, Gg, Gg, Gll^Fp, Gll^Fp, Gll^Fp, Gll^Fp, Gll^Fp, Gll^Fp, Gll^Fp, Ww, Ww, Cv, Cv, Cv, Ww, Gll^Fp, Ww, Gll^Fp, Gll^Fp, Gll^Fp, Ww, Ww, Gll^Fp, Ww, Gll^Fp, Gll^Fp, Gll^Fp, Gll^Fp, Gll^Fp, Gll^Fp, Gg, Gg, Gs^Es, Gll^Fp, Gg, Gll^Fp, Gll^Fp, Gll^Fp, Rp, Rp, Gll^Fp, Gll^Fp, Gll^Fp, Gll^Fp, Gll^Fp, Gll^Fp, Gll^Fp, Hh^Fp, Mm
Gg, Ce, Ce, Gg, Gg, Re^Es, Rd, Gg, Gg, Rd^Gvs, Rd^Gvs, Rd^Gvs, Gg, Gll^Fp, Gll^Fp, Gll^Fp, Gll^Fp, Gg^Ve, Gll^Fp, Gll^Fp, Gll^Fp, Gll^Fp, Ww, Cv, 8 Kv, Cv, Ww, Ww, Gll^Fp, Ww, Ww, Ww, Gll^Fp, Gll^Fp, Ss, Ss, Ss, Gll^Fp, Gll^Fp, Gg^Ve, Gll^Fp, Gg, Gg^Es, Cv, 7 Kv, Cv, Gs^Es, Gg, Rp, Rp, Gll^Fp, Gll^Fp, Gll^Fp, Gll^Fp, Gll^Fp, Gll^Fp, Hh, Gll^Fp, Hh, Hh, Hh
Gg, Gg, Gg, Gg, Ce, Gg, Rd, Gg^Ve, Gg, Rd^Gvs, Rd^Gvs, Rd^Gvs, Gg, Gll^Fp, Gll^Fp, Gll^Fp, Gll^Fp, Gll^Fp, Gll^Fp, Gll^Fp, Ww, Ww, Cv, Cv, Cv, Cv, Cv, Ww, Ww, Gll^Fp, Gg^Ve, Gll^Fp, Gll^Fp, Gll^Fp, Gll^Fp, Gll^Fp, Gll^Fp, Gll^Fp, Gll^Fp, Gll^Fp, Gg^Fet, Gll^Fp, Gs, Cv, Gg^Es, Cv, Rp, Rp, Gll^Fp, Gll^Fp, Gll^Fp, Gll^Fp, Gll^Fp, Gll^Fp, Gll^Fp, Hh, Gll^Fp, Hh, Hh, Hh, Hh
Gg, Gg, Hh, Ce, Hh, Gg, Gg, Rp, Rp, Gg, Gg, Rd^Gvs, Gg, Gg, Gll^Fp, Gll^Fp, Gll^Fp, Gll^Fp, Gll^Fp, Gll^Fp, Rp, Wwg^Bsb/, Ww, Ww, Ww, Ww, Ww, Wwg^Bsb\, Rp, Gll^Fp, Gll^Fp, Gll^Fp, Rp, Gll^Fp, Gll^Fp, Gll^Fp, Gll^Fp, Ss, Gg, Gll^Fp, Gll^Fp, Gll^Fp, Gg, Gg, Rp, Rp, Gll^Fp, Gll^Fp, Gll^Fp, Gll^Fp, Gll^Fp, Gll^Fp, Gll^Fp, Gll^Fp, Gll^Fp, Gll^Fp, Hh, Hh, Mm, Mm, Mm
Gg, Gg, Hh, Hh, Gg, Gg, Rd^Gvs, Gg, Gg, Rp, Gg, Gg, Gg, Gg, Gll^Fp, Gll^Fp, Gll^Fp, Gll^Fp, Gll^Fp, Gll^Fp, Gll^Fp, Gll^Fp, Gll^Fp, Gll^Fp, Ww, Gll^Fp, Gll^Fp, Gll^Fp, Gll^Fp, Rp, Rp, Rp, Gll^Fp, Rp, Rp, Gll^Fp, Gll^Fp, Gll^Fp, Gll^Fp, Gll^Fp, Gll^Fp, Gg, Gll^Fp, Rp, Gll^Fp, Gll^Fp, Gll^Fp, Gll^Fp, Gll^Fp, Gll^Fp, Hh^Fp, Gll^Fp, Gll^Fp, Gll^Fp, Hh, Hh, Hh, Hh, Hh, Mm, Mm
Gg, Gg, Gg, Hh, Hh, Gg, Rd^Gvs, Gg, Gg, Rp, Gg, Gg^Ve, Gg, Gll^Fp, Gll^Fp, Gll^Fp, Gll^Fp, Gll^Fp, Gll^Fp, Gll^Fp, Gll^Fp, Gll^Fp, Gll^Fp, Ww, Ww, Gll^Fp, Gll^Fp, Gll^Fp, Gll^Fp, Gll^Fp, Gll^Fp, Gll^Fp, Gll^Fp, Gll^Fp, Rp, Gll^Fp, Gll^Fp, Gll^Fp, Gg^Ve, Gll^Fp, Gll^Fp, Gll^Fp, Gll^Fp, Rp, Gll^Fp, Gg^Ve, Gg^Es, Gll^Fp, Gll^Fp, Gll^Fp, Hh, Gll^Fp, Gll^Fp, Gll^Fp, Hh, Hh, Gll^Fp, Hh, Hh, Mm, Mm
Gg, Gg, Gg, Gg^Ve, Gg, Gg, Rd^Gvs, Rd^Gvs, Gg, Rp, Rp, Gg, Gg, Gll^Fp, Gll^Fp, Gll^Fp, Gll^Fp, Gll^Fp, Gll^Fp, Gll^Fp, Gll^Fp, Gg, Gll^Fp, Gll^Fp, Gll^Fp, Ww, Ww, Ww, Gll^Fp, Gll^Fp, Gll^Fp, Gg^Fet, Gll^Fp, Gll^Fp, Gll^Fp, Rp, Rp, Gll^Fp, Gll^Fp, Gg, Rp, Gll^Fp, Rp, Rp, Hh^Fp, Gll^Fp, Hh, Gll^Fp, Hh^Fp, Hh, Gll^Fp, Gll^Fp, Gll^Fp, Gll^Fp, Gll^Fp, Gll^Fp, Hh, Hh, Mm, Mm, Mm
Gg, Gg, Gg, Gg, Gg, Rd^Gvs, Rd^Gvs, Rd^Gvs, Rd^Gvs, Gg, Rp, Gg, Gg, Gg, Gll^Fp, Gll^Fp, Gll^Fp, Gll^Fp, Gll^Fp, Gll^Fp, Gll^Fp, Gll^Fp, Gll^Fp, Gll^Fp, Gll^Fp, Ww, Gll^Fp, Ww, Ww, Gll^Fp, Gll^Fp, Gll^Fp, Gll^Fp, Gll^Fp, Gll^Fp, Gll^Fp, Gll^Fp, Rp, Rp, Rp, Rp, Rp, Rp, Hh, Hh, Hh, Hh^Fp, Hh, Hh, Hh, Gll^Fp, Gll^Fp, Gll^Fp, Gg^Ve, Gll^Fp, Gll^Fp, Hh, Hh, Mm, Mm, Hh
Gg, Gg, Gg, Gg, Gg, Gg, Rd^Gvs, Rd^Gvs, Rd^Gvs, Gg, Gg, Rp, Rp, Gg, Gll^Fp, Gll^Fp, Gll^Fp, Gg^Ve, Rp, Gll^Fp, Rp, Gll^Fp, Gll^Fp, Gll^Fp, Gll^Fp, Gll^Fp, Ww, Ww, Gll^Fp, Gll^Fp, Gll^Fp, Gll^Fp, Gll^Fp, Gll^Fp, Gll^Fp, Gll^Fp, Gg^Fet, Gll^Fp, Gll^Fp, Gll^Fp, Gll^Fp, Gll^Fp, Gll^Fp, Rp, Rp, Hh^Fp, Hh, Hh, Hh, Hh^Fp, Hh, Gll^Fp, Gll^Fp, Gll^Fp, Hh^Fp, Hh^Fp, Hh, Hh, Hh, Hh, Hh
Ds, Ds, Ds, Ds, Ds, Gg, Gg, Rd^Gvs, Rd^Gvs, Rd^Gvs, Gg, Gg^Ve, Rp, Gg, Gll^Fp, Gll^Fp, Gg, Gll^Fp, Gll^Fp, Rp, Gg^Fet, Rp, Gll^Fp, Gll^Fp, Gll^Fp, Gll^Fp, Gll^Fp, Ww, Ss, Gll^Fp, Gll^Fp, Gll^Fp, Gll^Fp, Gll^Fp, Gll^Fp, Gll^Fp, Gll^Fp, Gll^Fp, Gg, Gll^Fp, Gll^Fp, Gll^Fp, Gll^Fp, Rp, Rp, Hh, Gll^Fp, Gll^Fp, Gll^Fp, Hh, Gg^Es, Hh, Gll^Fp, Gll^Fp, Hh, Hh, Hh^Fp, Hh, Hh, Hh, Hh
Ww, Ww, Ww, Ww, Ds, Gg, Gg, Gg, Gg, Rd^Gvs, Gg, Gg, Rp, Gg, Gll^Fp, Gll^Fp, Gll^Fp, Gll^Fp, Gll^Fp, Rp, Gll^Fp, Rp, Gg^Ve, Gll^Fp, Gll^Fp, Ss, Ww, Ww, Gll^Fp, Gll^Fp, Gll^Fp, Gll^Fp, Gll^Fp, Gll^Fp, Gll^Fp, Gll^Fp, Gll^Fp, Gll^Fp, Gll^Fp, Gll^Fp, Gll^Fp, Gll^Fp, Rp, Rp, Gll^Fp, Rp, Rp, Gll^Fp, Gll^Fp, Gll^Fp, Gll^Fp, Gll^Fp, Gll^Fp, Hh, Hh, Hh, Hh, Hh, Ww, Ww, Ww
Ww, Ww, Ww, Ww, Ww, Ds, Gg, Gg, Gg, Gg, Gg, Gg, Rp, Gg, Gg, Gll^Fp, Gll^Fp, Gll^Fp, Gll^Fp, Gll^Fp, Gll^Fp, Gll^Fp, Gll^Fp, Gll^Fp, Gll^Fp, Ss, Ww, Gg, Ss, Ss, Gll^Fp, Gg^Fet, Gll^Fp, Gll^Fp, Gll^Fp, Gll^Fp, Gg, Gll^Fp, Rp, Rp, Rp, Rp, Gll^Fp, Gll^Fp, Gll^Fp, Gll^Fp, Gll^Fp, Rp, Rp, Gll^Fp, Gll^Fp, Gll^Fp, Gll^Fp, Gg, Gll^Fp, Gll^Fp, Hh, Hh, Ww, Hh, Hh
Ww, Ww, Ww, Ww, Gg, Gg, Gg, Gg, Gg, Gg, Gg, Gg, Ww^Bsb|, Gg, Gg, Gll^Fp, Gll^Fp, Gg, Gll^Fp, Gll^Fp, Gll^Fp, Gll^Fp, Gll^Fp, Gll^Fp, Gll^Fp, Gll^Fp, Ww, Gll^Fp, Ss, Gll^Fp, Ss, Gll^Fp, Gll^Fp, Gll^Fp, Gll^Fp, Gll^Fp, Rp, Rp, Gll^Fp, Gll^Fp, Gg^Ve, Gll^Fp, Gll^Fp, Gll^Fp, Gg^Fet, Gll^Fp, Gll^Fp, Rp, Rp, Gll^Fp, Gg^Ve, Gll^Fp, Hh, Gll^Fp, Hh^Fp, Gll^Fp, Ww, Ww, Hh, Hh, Mm
Ww, Ww, Ww, Ww, Ww, Gg, Ww, Gg, Ww, Gg, Ww, Ww, Rp, Ww, Ww, Gg, Wwg, Ww, Ww, Ww, Gll^Fp, Gll^Fp, Ww, Gll^Fp, Ww, Ww, Gll^Fp, Gll^Fp, Gll^Fp, Gg, Ss, Ss, Gll^Fp, Gg^Ve, Ss, Gll^Fp, Rp, Rp, Gll^Fp, Gll^Fp, Gll^Fp, Gll^Fp, Gll^Fp, Gll^Fp, Gll^Fp, Gll^Fp, Gll^Fp, Gll^Fp, Rp, Gll^Fp, Gll^Fp, Gll^Fp, Hh, Hh^Fp, Hh, Ww, Hh, Hh, Mm, Mm, Mm
Ww, Ww, Ww, Ww, Ww, Ww, Gg, Ww, Gg, Ww, Gg, Gg^Ve, Rp, Gg, Gg, Wwg, Gll^Fp, Gll^Fp, Gg, Ww, Ww, Ww, Gll^Fp, Ww, Ss, Ww, Gll^Fp, Ss, Gll^Fp, Ss, Gll^Fp, Gll^Fp, Gll^Fp, Ss, Rp, Ss^Bw/, Ss, Gll^Fp, Gll^Fp, Gll^Fp, Gll^Fp, Gll^Fp, Gll^Fp, Gll^Fp, Gll^Fp, Gll^Fp, Gll^Fp, Gll^Fp, Rp, Rp, Gll^Fp, Ss, Ww, Hh, Ww, Ww, Hh, Hh^Fp, Hh^Fp, Mm, Hh
Ww, Ww, Ww, Ww, Ds, Gg, Gg, Gg, Rd^Gvs, Gg, Gg, Gg, Rp, Gg, Gg, Gg, Gll^Fp, Gll^Fp, Gll^Fp, Gll^Fp, Ss, Gll^Fp, Gll^Fp, Ss, Gll^Fp, Gll^Fp, Ss, Gll^Fp, Gll^Fp, Ss, Gll^Fp, Gll^Fp, Gll^Fp, Rp, Rp, Ss, Gll^Fp, Ss, Gll^Fp, Gll^Fp, Ss, Gll^Fp, Gll^Fp, Gll^Fp, Ss, Gll^Fp, Gll^Fp, Gll^Fp, Gll^Fp, Rp, Rp, Gll^Fp, Ww, Ww, Ss, Ss, Hh, Hh, Hh, Hh, Gll^Fp
Ds, Ww, Ds, Ds, Gg, Gg, Rd^Gvs, Rd^Gvs, Rd^Gvs, Gg, Rp, Rp, Gg, Gg, Rd^Gvs, Gg, Gll^Fp, Gg^Ve, Gll^Fp, Gll^Fp, Gll^Fp, Gg, Gll^Fp, Gg, Gll^Fp, Gll^Fp, Gll^Fp, Gll^Fp, Gll^Fp, Gll^Fp, Gll^Fp, Gll^Fp, Rp, Rp, Gll^Fp, Gll^Fp, Gll^Fp, Ss, Gll^Fp, Gll^Fp, Ss, Gll^Fp, Gll^Fp, Ss, Ss, Gll^Fp, Ss, Gll^Fp, Gll^Fp, Ww, Ww, Wwg^Bsb\, Rp, Gll^Fp, Gll^Fp, Gll^Fp, Hh, Gll^Fp, Gll^Fp, Gll^Fp, Gll^Fp
Gg, Ds, Ce, Gg, Gg, Ce, Rd^Gvs, Rd^Gvs, Gg, Gg, Rp, Gg, Rd^Gvs, Rd^Gvs, Rd^Gvs, Gg, Gg, Gll^Fp, Gll^Fp, Gll^Fp, Gg^Fet, Gll^Fp, Gll^Fp, Gg^Ve, Gll^Fp, Gll^Fp, Rp, Rp, Rp, Gll^Fp, Rp, Rp, Gll^Fp, Gll^Fp, Gg^Es, Gll^Fp, Gll^Fp, Gll^Fp, Gll^Fp, Ss, Gll^Fp, Ss, Ss, Ss, Ss, Ss, Gll^Fp, Gll^Fp, Ww, Ww, Gll^Fp, Gll^Fp, Gll^Fp, Rp, Gll^Fp, Gll^Fp, Gll^Fp, Gll^Fp, Gll^Fp, Gll^Fp, Gll^Fp
Gg, Ce, 5 Ke, Ce, Gg, Ce, Gg, Gg, Gg, Gg^Ve, Rp, Gg, Gg, Rd^Gvs, Rd^Gvs, Gg, Gg, Gll^Fp, Gg, Gll^Fp, Gll^Fp, Gll^Fp, Gll^Fp, Gg, Rp, Rp, Gll^Fp, Gg, Gll^Fp, Rp, Gll^Fp, Rp, Rp, Gg^Ve, Gg, Gll^Fp, Gll^Fp, Gll^Fp, Gll^Fp, Gll^Fp, Gll^Fp, Gll^Fp, Gll^Fp, Gll^Fp, Wwg, Wwg, Wwg, Ww, Gll^Fp, Ww, Gll^Fp, Gll^Fp, Gll^Fp, Rp, Gg^Ve, Gll^Fp, Gll^Fp, Gll^Fp, Gll^Fp, Gll^Fp, Gll^Fp
Gg, Ce, Ce, Ce, Gg, Gg, Gg, Rd^Gvs, Rd^Gvs, Gg, Gg, Rp, Gg, Rd^Gvs, Rd^Gvs, Rd^Gvs, Gg, Gg, Gg, Gll^Fp, Gll^Fp, Gll^Fp, Gll^Fp, Rp, Gll^Fp, Gll^Fp, Gll^Fp, Gg^Ve, Gll^Fp, Gll^Fp, Gll^Fp, Rp, Rp, Gll^Fp, Gll^Fp, Gll^Fp, Gll^Fp, Gg^Fet, Gll^Fp, Gll^Fp, Ss, Gll^Fp, Gll^Fp, Wwg, Gll^Fp, Gll^Fp, Gll^Fp, Ww, Gll^Fp, Gll^Fp, Gll^Fp, Gll^Fp, Rp, Rp, Hh^Fp, Gll^Fp, Gll^Fp, Gg^Fet, Gll^Fp, Gg, Gll^Fp
Gg, Gg, Gg, Gg, Gg, Gg^Ve, Gg, Rd^Gvs, Rd^Gvs, Rd^Gvs, Gg, Rp, Rp, Gg, Gg, Rd^Gvs, Gg, Gg, Gg, Gg, Gll^Fp, Gll^Fp, Rp, Rp, Gll^Fp, Gll^Fp, Gll^Fp, Gll^Fp, Gg, Ss, Gll^Fp, Gg, Rp, Rp, Gll^Fp, Gll^Fp, Gll^Fp, Gll^Fp, Gll^Fp, Ss, Ss, Gll^Fp, Ww, Ww, Gll^Fp, Gll^Fp, Gg^Ve, Gll^Fp, Gll^Fp, Gll^Fp, Gll^Fp, Gll^Fp, Rp, Rp, Hh^Fp, Gll^Fp, Gll^Fp, Gll^Fp, Gll^Fp, Gll^Fp, Gll^Fp
Gg, Gg, Ce, Ce, Gg, Gg, Rd^Gvs, Rd^Gvs, Rd^Gvs, Rd^Gvs, Rd^Gvs, Gg^Ve, Gg, Rp, Rp, Gg, Gg, Gg, Gg, Gll^Fp, Rp, Rp, Gll^Fp, Gll^Fp, Gll^Fp, Gll^Fp, Ss, Gll^Fp, Gll^Fp, Ss, Gll^Fp, Gll^Fp, Gll^Fp, Rp, Rp, Gll^Fp, Gll^Fp, Gll^Fp, Gll^Fp, Gll^Fp, Gll^Fp, Gll^Fp, Ww, Gll^Fp, Ss, Gll^Fp, Gll^Fp, Gll^Fp, Gll^Fp, Gll^Fp, Gll^Fp, Rp, Hh, Hh^Fp, Hh, Hh, Gll^Fp, Gll^Fp, Gll^Fp, Gll^Fp, Gll^Fp
Gg, Gg, Gg, Gg, Gg, Gg, Rd^Gvs, Rd^Gvs, Rd^Gvs, Rd^Gvs, Rd^Gvs, Rd^Gvs, Rd^Gvs, Gg, Gg, Rp, Rp, Rp, Rp, Rp, Gg, Gg, Gll^Fp, Gll^Fp, Gll^Fp, Gll^Fp, Gll^Fp, Gll^Fp, Gll^Fp, Gll^Fp, Gll^Fp, Gll^Fp, Gll^Fp, Gll^Fp, Gll^Fp, Rp, Gll^Fp, Gll^Fp, Gll^Fp, Ww, Ww, Ww, Ww, Ww, Ww, Ss, Gll^Fp, Gll^Fp, Gg^Fet, Gll^Fp, Rp, Rp, Hh, Hh^Fp, Hh, Gll^Fp, Gll^Fp, Gll^Fp, Gll^Fp, Gll^Fp, Gll^Fp
Gs^Fms, Gg, Gg, Gg, Gg, Gg, Gg, Rd^Gvs, Gg, Rd^Gvs, Gg, Gg, Gg, Gg, Gg^Ve, Rp, Gg, Gg, Gg, Gg, Gg, Gg, Gg, Gll^Fp, Gll^Fp, Gll^Fp, Gll^Fp, Gll^Fp, Gll^Fp, Gll^Fp, Gll^Fp, Gll^Fp, Gll^Fp, Gg^Ve, Gll^Fp, Rp, Rp, Gll^Fp, Ww, Ww, Ce, Ce, Ce, Ce, Ce, Ww, Gll^Fp, Gll^Fp, Gll^Fp, Gll^Fp, Rp, Rp, Hh^Fp, Hh, Hh, Gll^Fp, Gll^Fp, Gll^Fp, Gll^Fp, Gll^Fp, Gll^Fp
Gg, Gg, Gg, Gg, Gs^Fds, Gg, Gg, Gg, Gg, Gg, Rp, Rp, Rp, Gg, Rp, Rp, Gg, Gg, Gg, Gg, Gg, Gg, Gg, Gll^Fp, Gll^Fp, Gg^Fet, Gll^Fp, Gll^Fp, Rp, Gll^Fp, Gg, Gll^Fp, Gll^Fp, Gll^Fp, Gll^Fp, Gll^Fp, Gll^Fp, Rp, Rp, Ww, Ce, 1 Ke, Ce, 2 Ke, Ce, Ww, Gll^Fp, Gll^Fp, Rp, Rp, Hh, Hh, Hh, Hh, Gll^Fp, Hh^Fp, Gll^Fp, Gll^Fp, Gll^Fp, Gll^Fp, Gll^Fp
Gg, Gg, Gg, Gg, Gs^Fms, Gs^Fds, Gg, Gg^Ve, Rp, Rp, Gg, Gg, Gg, Rp, Gg, Gg, Gg, Gg, Gg, Gg, Gg, Gg, Gg, Gll^Fp, Gll^Fp, Gll^Fp, Gll^Fp, Gll^Fp, Gg^Ve, Rp, Gll^Fp, Gll^Fp, Gll^Fp, Gll^Fp, Ss, Gll^Fp, Gll^Fp, Rp, Wwg^Bsb\, Ww, Rp, Ce, Gll^Fp, Ce, Ww, Ww, Rp, Rp, Gll^Fp, Gg^Ve, Gll^Fp, Hh^Fp, Gll^Fp, Gll^Fp, Gll^Fp, Gg, Gll^Fp, Gll^Fp, Gll^Fp, Gll^Fp, Gll^Fp
Gg, Gg, Gg, Gg, Gg, Gg, Gs^Fms, Gg, Rp, Gg, Gg, Gg, Gg, Gg, Gg, Gg, Gg, Gg, Gg, Gg, Gg, Gg, Gg, Gll^Fp, Gg, Gll^Fp, Gll^Fp, Gll^Fp, Gll^Fp, Gll^Fp, Gll^Fp, Gll^Fp, Gll^Fp, Gll^Fp, Ss, Ss, Gll^Fp, Ww, Ww, Rp, Gll^Fp, Rp, Rp, Gll^Fp, Rp, Wwg^Bsb/, Gll^Fp, Gll^Fp, Gll^Fp, Gll^Fp, Gll^Fp, Gll^Fp, Gll^Fp, Gll^Fp, Gll^Fp, Gll^Fp, Gll^Fp, Gll^Fp, Gll^Fp, Gll^Fp, Gll^Fp
Ww, Ww, Ww, Gg, Gg, Gg, Gg, Gg, Gg, Rp, Rp, Gg, Gg, Gg, Gg, Gg, Ww, Gg, Ww, Gg, Gll^Fp, Gll^Fp, Gll^Fp, Gg, Gg, Gg, Gll^Fp, Gg, Gll^Fp, Gll^Fp, Ss, Gll^Fp, Gll^Fp, Ss, Gll^Fp, Gll^Fp, Ww, Ww, Ss, Gll^Fp, Gg^Fet, Gll^Fp, Gll^Fp, Rp, Gll^Fp, Ww, Ww, Gll^Fp, Gll^Fp, Gll^Fp, Gll^Fp, Gll^Fp, Gll^Fp, Gll^Fp, Gll^Fp, Gll^Fp, Gll^Fp, Gll^Fp, Gll^Fp, Gll^Fp, Gll^Fp
Gg, Gg, Gg, Ww, Gg, Gg, Gg, Gg, Gg, Gg, Gg, Rp, Rp, Ww, Ww, Ww, Ww, Ww, Ww, Ww, Gll^Fp, Gll^Fp, Gll^Fp, Gll^Fp, Gg, Gll^Fp, Gll^Fp, Gll^Fp, Gll^Fp, Gll^Fp, Gll^Fp, Gll^Fp, Ww, Gll^Fp, Ww, Ww, Gll^Fp, Gll^Fp, Gll^Fp, Gll^Fp, Gll^Fp, Gll^Fp, Gll^Fp, Rp, Gll^Fp, Ww, Ww, Gll^Fp, Gll^Fp, Gll^Fp, Gll^Fp, Gll^Fp, Gll^Fp, Gll^Fp, Gll^Fp, Gg^Ve, Gll^Fp, Gg^Fet, Gll^Fp, Gll^Fp, Gll^Fp
Gs^Fms, Gs^Fds, Gg, Ww, Ww, Ww, Ww, Gg, Gg, Gs^Fms, Gs^Fds, Gs^Fms, Gg, Ww^Bsb\, Rp, Gg, Gg, Gg, Gg, Ww, Ww, Ww, Ww, Gll^Fp, Ww, Gg, Ww, Gll^Fp, Ww, Gll^Fp, Ww, Ww, Gll^Fp, Ww, Gll^Fp, Gll^Fp, Ss, Ss, Gll^Fp, Gll^Fp, Gll^Fp, Gg^Es, Gll^Fp, Rp, Gll^Fp, Gll^Fp, Gll^Fp, Ww, Ww, Gll^Fp, Gll^Fp, Gll^Fp, Gll^Fp, Gll^Fp, Gll^Fp, Gll^Fp, Gll^Fp, Gll^Fp, Gll^Fp, Gll^Fp, Gll^Fp
Gs^Fms, Gs^Fms, Gg, Gg, Gs^Fms, Gg, Gg, Ww, Gg, Gs^Fms, Gs^Fms, Gg, Ww, Ww, Ce, Rp, Rp, Ce, Gg, Gg, Gg, Gg, Ww, Ww, Ww, Ww, Ww, Ww, Ww, Ww, Ss, Ww, Gll^Fp, Gll^Fp, Gll^Fp, Gll^Fp, Gll^Fp, Gll^Fp, Gll^Fp, Gll^Fp, Gll^Fp, Gg^Ve, Rp, Rp, Rp, Gll^Fp, Gll^Fp, Gll^Fp, Ww, Gll^Fp, Gll^Fp, Gll^Fp, Gg, Gll^Fp, Gll^Fp, Gll^Fp, Gll^Fp, Gll^Fp, Gll^Fp, Gll^Fp, Gll^Fp
Rp, Gs^Fms, Gg, Gs^Fms, Gs^Fms, Gg, Gg, Ww, Ww, Ww, Ww, Ww, Gg, Ce, 4 Ke, Ce, Rp, Ce, Gg, Gg, Gg, Gg, Gg, Ww, Gg, Gg, Gg, Gg, Gg, Gll^Fp, Gg, Gll^Fp, Gll^Fp, Gg^Ve, Rp, Gll^Fp, Rp, Gll^Fp, Rp, Rp, Rp, Rp, Gll^Fp, Gll^Fp, Gll^Fp, Rp, Rp, Gll^Fp, Ww, Gll^Fp, Gll^Fp, Gll^Fp, Gll^Fp, Gg, Gll^Fp, Gll^Fp, Gg, Gll^Fp, Gll^Fp, Gll^Fp, Gll^Fp
Rp, Rp, Rp, Rp, Rp, Gg^Ve, Gg, Gg, Gg, Gg, Gg, Gg, Gg, Ce, Ce, Ce, Rp, Rp, Rp, Rp, Rp, Gg, Gg, Gg, Gg, Gg, Gg, Gg, Gg, Gll^Fp, Rp, Gg, Rp, Rp, Gll^Fp, Rp, Gll^Fp, Rp, Gll^Fp, Gll^Fp, Gll^Fp, Gll^Fp, Gll^Fp, Gll^Fp, Gll^Fp, Gg, Rp, Gg, Gg, Ww, Gll^Fp, Gll^Fp, Gll^Fp, Gll^Fp, Gll^Fp, Gll^Fp, Gll^Fp, Gll^Fp, Gg^Ve, Gll^Fp, Gll^Fp
Gg, Gg, Gg, Gg, Gg, Rp, Rp, Gg, Rp, Gg, Rp, Gg, Rp, Rp, Rp, Rp, Gg, Gg, Gg, Gg, Gg, Rp, Rp, Rp, Rp, Rp, Rp, Gg, Rp, Rp, Gll^Fp, Rp, Gll^Fp, Gll^Fp, Gll^Fp, Gll^Fp, Gll^Fp, Gll^Fp, Gg^Ve, Gll^Fp, Gll^Fp, Gll^Fp, Ce, Gll^Fp, Ce, Gg, Rp, Gg, Gg, Ww, Gll^Fp, Gll^Fp, Gll^Fp, Gll^Fp, Gg^Fet, Gll^Fp, Gll^Fp, Gll^Fp, Gll^Fp, Gll^Fp, Gll^Fp
Gg, Gg, Gg, Gg, Gg, Gg, Gg, Rp, Gg, Rp, Gg, Rp, Gg, Gg^Ve, Gg, Gg, Gg, Gg, Gg, Gg, Gg, Gg, Gg, Gg, Gg, Gg, Gg, Rp, Gg, Gg, Gg, Gll^Fp, Gll^Fp, Gll^Fp, Gll^Fp, Gg^Fet, Gll^Fp, Gll^Fp, Gll^Fp, Gll^Fp, Gll^Fp, Ce, Ce, 3 Ke, Ce, Ce, Gg, Rp, Gll^Fp, Ww, Ww, Gll^Fp, Gll^Fp, Gll^Fp, Gll^Fp, Gll^Fp, Gll^Fp, Gll^Fp, Gll^Fp, Gll^Fp, Gll^Fp
Gg, Gg, Gg, Gg, Gg, Gg, Gg, Gg, Gg, Gg, Gg, Gg, Gg, Gg, Gg, Gg, Gg, Gg, Gg, Gg, Gg, Gg, Gg, Gg, Gg, Gg, Gg, Gg, Gg, Gg, Gg, Gg, Gll^Fp, Gll^Fp, Gll^Fp, Gll^Fp, Gll^Fp, Gll^Fp, Gll^Fp, Gll^Fp, Gll^Fp, Gll^Fp, Gll^Fp, Gll^Fp, Gll^Fp, Gll^Fp, Gll^Fp, Rp, Gll^Fp, Gll^Fp, Ww, Gll^Fp, Gll^Fp, Gll^Fp, Gll^Fp, Gll^Fp, Gll^Fp, Gg, Gll^Fp, Gll^Fp, Gll^Fp
