Hhd, Hhd, Hhd, Gg, Gg, Gg, Gg, Gg, Gg, Gg, Gll^Fp, Gll^Fp, Gs^Fms, Gg^Fet, Gs^Fms, Gll^Fp, Gll^Fp, Gll^Fp, Gll^Fp, Gll^Fp, Gll^Fp, Gll^Fp, Gll^Fp, Gll^Fp, Gll^Fp, Gll^Fp, Gs^Fms, Rp, Gs^Fms, Gll^Fp, Gll^Fp, Gll^Fp, Gll^Fp, Gll^Fp, Gll^Fp, Gll^Fp, Ww, Ww, Gll^Fp, Gll^Fp, Gll^Fp, Gll^Fp, Gll^Fp, Gll^Fp, Gll^Fp, Gll^Fp, Hh, Hh, Hh, Ms, Ms, Ms, Ms, Hh, Hh, Hh, Rp, Rp, Hh, Hh, Hh
Hhd, Hhd, Hhd, Hhd, Hhd, Gg, Gg, Gg, Gg, Gg, Gg, Gll^Fp, Gs^Fms, Gs^Fms, Gll^Fp, Gs^Fms, Gll^Fp, Gll^Fp, Gll^Fp, Gll^Fp, Gll^Fp, Gll^Fp, Gll^Fp, Gs, Gs, Gll^Fp, Rp, Rp, Gs^Fms, Gs, Gs, Gll^Fp, Gs, Gll^Fp, Gll^Fp, Gll^Fp, Ww, Gll^Fp, Gll^Fp, Gll^Fp, Gs^Fms, Gll^Fp, Gll^Fp, Gs^Fms, Gll^Fp, Hh, Hh, Hh^Fp, Ms, Ms, Ms, Ms, Ms, Hh, Hh, Hh, Rp, Hh, Hh, Ms, Ms
Re, Hhd, Hhd, Hhd, Hhd, Gg, Gg, Gg, Hh, Gg, Gg, Gg, Gll^Fp, Gs^Fms, Gll^Fp, Gg^Fet, Gll^Fp, Gll^Fp, Gll^Fp, Gll^Fp, Gs, Gs^Fms, Gs^Fms, Gs, Rp, Rp, Gll^Fp, Gs^Fms, Gs, Gs, Gll^Fp, Gg^Fet, Gs^Fms, Gll^Fp, Gs^Fms, Gll^Fp, Ww, Gs^Fms, Gll^Fp, Gll^Fp, Gll^Fp, Gg^Ve, Gs^Fms, Gll^Fp, Gll^Fp, Hh^Fp, Hh^Fp, Ms, Hh, Ms, Hh, Ms, Hh^Fp, Hh, Hh, Rp, Hh, Hh, Ms, Ms, Ms
Hhd, Re, Hhd, Hhd, Re, Hhd, Gg, Gg, Gg, Hh, Gg, Gg, Gg, Gll^Fp, Gll^Fp, Gll^Fp, Gll^Fp, Gg^Ve, Gll^Fp, Gll^Fp, Gll^Fp, Gll^Fp, Gll^Fp, Gs, Rp, Gll^Fp, Gs^Fms, Gll^Fp, Gll^Fp, Gs^Fms, Ww, Gll^Fp, Gll^Fp, Gll^Fp, Ww, Ww, Gll^Fp, Gs^Fms, Gs, Gs, Gs, Gll^Fp, Gll^Fp, Gll^Fp, Gll^Fp, Hh, Gll^Fp, Hh, Hh, Hh, Hh, Hh, Hh^Fp, Hh, Rp, Rp, Hh, Hh, Ms, Ms, Ms
Hhd, Re, Re, Hhd, Hhd, Ce, Gg, Gg, Re^Es, Gg, Gg, Gg, Gg, Gll^Fp, Gll^Fp, Gll^Fp, Gll^Fp, Gs^Fms, Gll^Fp, Gll^Fp, Gll^Fp, Gg^Ve, Gll^Fp, Gll^Fp, Rp, Gll^Fp, Gll^Fp, Gs^Fms, Ww, Ww, Gll^Fp, Ww, Ww, Ww, Gll^Fp, Gll^Fp, Gs, Gll^Fp, Gll^Fp, Gs, Gll^Fp, Gll^Fp, Gll^Fp, Gll^Fp, Gg^Fet, Gs^Fms, Gll^Fp, Hh, Gll^Fp, Gs^Fp, Gll^Fp, Gll^Fp, Rp, Rp, Gll^Fp, Hh, Gll^Fp, Ms, Hh, Hh, Ms
Hhd, Hhd, Ce, Re, Re, Ce, Gs, Gg, Rd^Gvs, Gg^Ve, Rd^Gvs, Gg, Gg, Gll^Fp, Gll^Fp, Gll^Fp, Gll^Fp, Gll^Fp, Gll^Fp, Gs, Gll^Fp, Gll^Fp, Ww, Ww, Ww^Bsb|, Ww, Ww, Ww, Gs^Fms, Gs^Fms, Gs^Fms, Gll^Fp, Gll^Fp, Gll^Fp, Gll^Fp, Gll^Fp, Gs, Gll^Fp, Gll^Fp, Gs^Efm, Gll^Fp, Gll^Fp, Gs^Fms, Gll^Fp, Gll^Fp, Gll^Fp, Gs^Fms, Gs^Fms, Gll^Fp, Gll^Fp, Rp, Rp, Gll^Fp, Gg^Ve, Gll^Fp, Gll^Fp, Gll^Fp, Hh, Hh, Hh^Fp, Ms
Hhd, 6 Ke, Ce, Ce, Re, Ce, Gs, Gg, Rd^Gvs, Rd^Gvs, Rd^Gvs, Gg, Gg, Gg, Gs^Fms, Gll^Fp, Gll^Fp, Gll^Fp, Gll^Fp, Gs, Gs^Fms, Gll^Fp, Ww, Cv, Cv, Cv, Ww, Gs^Fms, Gll^Fp, Gll^Fp, Gll^Fp, Gs^Fms, Gll^Fp, Gs^Fms, Gs^Fms, Gll^Fp, Gll^Fp, Gll^Fp, Gll^Fp, Gll^Fp, Gg^Ve, Gll^Fp, Gll^Fp, Gll^Fp, Gll^Fp, Gll^Fp, Gs^Fms, Gs^Fms, Rp, Rp, Gll^Fp, Gll^Fp, Gs, Gll^Fp, Gs^Fms, Gs^Fms, Gll^Fp, Gll^Fp, Gll^Fp, Hh^Fp, Ms
Gs, Ce, Ce, Gs, Gs, Re^Es, Re, Gg, Gg, Gg, Rd^Gvs, Gg, Gg, Gll^Fp, Gll^Fp, Gll^Fp, Gll^Fp, Gll^Fp, Gs, Gs, Gll^Fp, Gll^Fp, Ww, Cv, 8 Kv, Cv, Ww, Gll^Fp, Gll^Fp, Gll^Fp, Gll^Fp, Gs, Gll^Fp, Gll^Fp, Gg^Ve, Gll^Fp, Gll^Fp, Gll^Fp, Gs, Gll^Fp, Gll^Fp, Gll^Fp, Gs, Cv, 7 Kv, Cv, Rp, Rp, Gll^Fp, Gll^Fp, Gs, Gs, Gll^Fp, Gll^Fp, Gll^Fp, Gll^Fp, Hh, Gll^Fp, Hh, Hh, Hh
Gs, Gs, Gs, Gs, Ce, Ce, Re, Gg, Gg, Gg, Gg, Gg, Gg, Gll^Fp, Gll^Fp, Gll^Fp, Gll^Fp, Gg^Fet, Gs, Gll^Fp, Gll^Fp, Ww, Cv, Cv, Cv, Cv, Cv, Ww, Gs^Fms, Gll^Fp, Gll^Fp, Gs^Fms, Gg^Fet, Gll^Fp, Gll^Fp, Gll^Fp, Gs, Gs, Gll^Fp, Gll^Fp, Gll^Fp, Gll^Fp, Gs, Cv, Gll^Fp, Cv, Rp, Gs^Fms, Gs^Fms, Gs^Fms, Gll^Fp, Gs, Gll^Fp, Gll^Fp, Gll^Fp, Hh, Gg^Fet, Hh, Hh, Hh, Hh
Gs, Gs, Hh, Ce, Hh, Gg, Gg, Rp, Rp, Gg, Gg, Gg, Gg^Efm, Gg, Gll^Fp, Gll^Fp, Gll^Fp, Gs, Gll^Fp, Gll^Fp, Gs, Ww, Ww, Ww, Ww^Bsb|, Ww, Ww, Ww, Gs^Fms, Gll^Fp, Gll^Fp, Gll^Fp, Gll^Fp, Gs^Fms, Gll^Fp, Gll^Fp, Gll^Fp, Gll^Fp, Gll^Fp, Gs, Gs, Gll^Fp, Gll^Fp, Gll^Fp, Rp, Rp, Gg^Ve, Gll^Fp, Gll^Fp, Gs^Fms, Gs, Gs, Gll^Fp, Gll^Fp, Gll^Fp, Gll^Fp, Hh, Hh, Ms, Ms, Ms
Gs, Gg, Hh, Hh, Gll^Fp, Gg, Gg, Gg, Gg, Rp, Gg, Gg, Gg, Gg, Gs^Fms, Gll^Fp, Gll^Fp, Gll^Fp, Gll^Fp, Gll^Fp, Gll^Fp, Gll^Fp, Ww, Gll^Fp, Rp, Gll^Fp, Gll^Fp, Gs^Fms, Gg^Ve, Gs^Fms, Gll^Fp, Gll^Fp, Gll^Fp, Gs^Fms, Gs, Gll^Fp, Gll^Fp, Gll^Fp, Gll^Fp, Gs^Fms, Gll^Fp, Gll^Fp, Gll^Fp, Gll^Fp, Rp, Gll^Fp, Gll^Fp, Gll^Fp, Gs^Fms, Gll^Fp, Gll^Fp, Gll^Fp, Gll^Fp, Gll^Fp, Hh, Hh, Hh, Hh, Hh, Ms, Ms
Gg, Gg, Gg, Hh, Hh, Gll^Fp, Rd^Gvs, Rd^Gvs, Gg, Rp, Gg, Gg, Gg, Gs^Fms, Gs^Fms, Gll^Fp, Gll^Fp, Gg^Ve, Gll^Fp, Gll^Fp, Ww, Ww, Gs^Fms, Gs^Es, Gll^Fp, Rp, Rp, Gll^Fp, Gs^Fms, Gs^Fms, Rp, Gs^Fms, Gs^Fms, Gll^Fp, Gs, Gs, Gs, Gll^Fp, Gs^Fms, Gs^Fms, Gs^Fms, Gg^Ve, Gll^Fp, Gs^Fms, Rp, Gll^Fp, Gll^Fp, Gll^Fp, Gll^Fp, Gll^Fp, Gll^Fp, Gll^Fp, Gll^Fp, Gs, Hh, Hh, Gll^Fp, Hh, Hh, Ms, Ms
Gg, Gg, Gg, Gg, Gg^Ve, Rd^Gvs, Rd^Gvs, Gg, Gg, Rp, Rp, Gg, Gg, Gs^Fms, Gll^Fp, Gll^Fp, Gll^Fp, Gll^Fp, Gll^Fp, Gll^Fp, Ww, Gll^Fp, Gs, Gs, Gll^Fp, Gll^Fp, Gll^Fp, Rp, Rp, Rp, Gll^Fp, Rp, Rp, Gll^Fp, Gs^Es, Gll^Fp, Gll^Fp, Gll^Fp, Gll^Fp, Gll^Fp, Gll^Fp, Gs, Rp, Rp, Gs, Gs^Fms, Gs^Fms, Gll^Fp, Gll^Fp, Gll^Fp, Gll^Fp, Gll^Fp, Gs, Gll^Fp, Gll^Fp, Gll^Fp, Hh, Hh, Ms, Ms, Ms
Gg, Gg, Gg, Gg, Gg, Rd^Gvs, Gg^Efm, Gg, Gg, Gg, Rp, Gg, Gg, Gg, Gll^Fp, Gll^Fp, Gll^Fp, Gll^Fp, Ww, Ww, Gll^Fp, Gs^Fms, Gs, Gs, Gs, Gll^Fp, Gll^Fp, Gll^Fp, Gll^Fp, Gll^Fp, Gll^Fp, Gs^Fms, Gll^Fp, Rp, Rp, Gll^Fp, Gll^Fp, Gs^Fms, Gll^Fp, Gll^Fp, Gll^Fp, Gs^Fms, Rp, Gs, Gs^Fms, Gs^Fms, Gs^Fms, Gs^Fms, Gll^Fp, Gll^Fp, Gll^Fp, Gll^Fp, Gs^Fms, Gs^Fms, Gll^Fp, Gs^Fp, Hh, Hh, Ms, Ms, Hh
Gg, Gg, Gg, Gg, Gg, Gg, Rd^Gvs, Gg, Gg, Gg, Gg^Ve, Rp, Rp, Gg, Gll^Fp, Gll^Fp, Gll^Fp, Ww, Gll^Fp, Gll^Fp, Gll^Fp, Gll^Fp, Gll^Fp, Gs^Fms, Gll^Fp, Gs, Gll^Fp, Gs, Gll^Fp, Gs^Fms, Gll^Fp, Gll^Fp, Gs, Gs, Gs, Rp, Gll^Fp, Gg^Fet, Gll^Fp, Gs, Gll^Fp, Gll^Fp, Rp, Gs, Gs, Gll^Fp, Gll^Fp, Gll^Fp, Gll^Fp, Gll^Fp, Gll^Fp, Gll^Fp, Gll^Fp, Gs^Fms, Hh^Fp, Hh^Fp, Hh, Hh, Hh, Hh, Hh
Gg, Gg, Gg, Rd^Gvs, Rd^Gvs, Gg, Rd^Gvs, Rd^Gvs, Gg, Rd^Gvs, Rd^Gvs, Gg, Rp, Gg, Gll^Fp, Gll^Fp, Gll^Fp, Ww, Gll^Fp, Gll^Fp, Gg^Ve, Gll^Fp, Gll^Fp, Gll^Fp, Gll^Fp, Gg^Fet, Gll^Fp, Gll^Fp, Gll^Fp, Gll^Fp, Gg^Ve, Gll^Fp, Gs^Fms, Gs, Gs^Fms, Rp, Gll^Fp, Gll^Fp, Gs^Fms, Gs^Fms, Rp, Rp, Gll^Fp, Gs, Gll^Fp, Gll^Fp, Gll^Fp, Gll^Fp, Gll^Fp, Gg^Ve, Gs^Fms, Gll^Fp, Gll^Fp, Gll^Fp, Hh, Hh, Hh^Fp, Hh, Hh, Hh, Hh
Gg, Gg, Gg, Rd^Gvs, Gg, Rd^Gvs, Gg^Ve, Rd^Gvs, Gg, Gg, Gg, Gg, Rp, Gg, Gll^Fp, Gll^Fp, Gll^Fp, Ww, Gll^Fp, Gll^Fp, Gll^Fp, Gll^Fp, Gll^Fp, Gll^Fp, Gll^Fp, Gll^Fp, Gll^Fp, Gll^Fp, Gs^Fms, Gll^Fp, Gll^Fp, Gll^Fp, Gs^Fms, Gll^Fp, Gs^Fms, Rp, Gll^Fp, Gll^Fp, Rp, Rp, Gll^Fp, Gs^Fms, Gll^Fp, Gll^Fp, Gll^Fp, Gll^Fp, Gll^Fp, Gs, Gll^Fp, Gll^Fp, Gs^Fms, Gll^Fp, Gs^Fms, Hh, Hh, Hh, Hh, Hh, Ww, Ww, Ww
Gg, Gg, Gg, Gg, Gg, Gg, Gg, Gg, Gg, Gg, Gg, Gg, Rp, Gg, Gg, Gll^Fp, Ww, Ww, Gll^Fp, Gll^Fp, Gll^Fp, Gll^Fp, Gs, Gll^Fp, Gll^Fp, Gs^Fms, Gll^Fp, Gs, Gs, Gll^Fp, Rp, Gll^Fp, Gll^Fp, Gs^Fms, Gs, Rp, Rp, Rp, Gll^Fp, Gll^Fp, Gll^Fp, Gs, Gll^Fp, Gll^Fp, Gll^Fp, Gs^Fms, Gs, Gll^Fp, Gll^Fp, Gll^Fp, Gs^Fms, Gll^Fp, Gll^Fp, Gll^Fp, Gg^Fet, Gs^Fms, Hh, Hh, Ww, Hh, Hh
Gll^Fp, Gg, Gll^Fp, Gs^Fms, Gg, Gg, Gg, Gg, Gg, Gg, Gg, Gg, Wwg^Bsb|, Gg, Ww, Ww, Gll^Fp, Gs^Fms, Gll^Fp, Gs, Gll^Fp, Gll^Fp, Gll^Fp, Gll^Fp, Gll^Fp, Gll^Fp, Gs, Gs, Rp, Rp, Gll^Fp, Rp, Rp, Gll^Fp, Rp, Rp, Rp, Gll^Fp, Gll^Fp, Gs^Fms, Gs, Gs, Gs, Gll^Fp, Gg^Fet, Gll^Fp, Gs, Gll^Fp, Gs, Gs^Fms, Gs^Fms, Gs^Fms, Gll^Fp, Gll^Fp, Gll^Fp, Gll^Fp, Ww, Ww, Hh, Hh, Ms
Gll^Fp, Gll^Fp, Gs^Fms, Gs^Fms, Gll^Fp, Gll^Fp, Gs^Fms, Gs^Fms, Gg, Gg, Wwg, Wwg, Rp, Wwg, Ww, Gg, Gll^Fp, Gs^Fms, Gs, Gs, Gll^Fp, Gll^Fp, Gll^Fp, Gll^Fp, Gll^Fp, Gs, Gll^Fp, Rp, Gs, Gs, Gs^Fms, Gll^Fp, Gll^Fp, Rp, Gll^Fp, Gll^Fp, Gll^Fp, Rp, Rp, Gll^Fp, Gll^Fp, Gs, Gll^Fp, Gll^Fp, Gll^Fp, Gs^Fms, Gll^Fp, Gll^Fp, Gs, Gll^Fp, Gs^Fms, Gll^Fp, Gll^Fp, Gll^Fp, Gll^Fp, Ww, Hh, Hh, Ms, Ms, Ms
Ww, Ww, Ww, Gs^Fms, Ww, Ww, Ww, Ww, Ww, Ww, Gg, Gg, Rp, Gg, Gg, Gll^Fp, Gll^Fp, Gll^Fp, Gll^Fp, Gs^Es, Gs, Gll^Fp, Gll^Fp, Gll^Fp, Gs^Fms, Gll^Fp, Gg^Ve, Rp, Gs^Fms, Gs^Fms, Gll^Fp, Gs^Fms, Gll^Fp, Gll^Fp, Gll^Fp, Gll^Fp, Gll^Fp, Gs, Rp, Gs^Fms, Gs^Fms, Gll^Fp, Gs, Gs^Fms, Gs^Fms, Gll^Fp, Gs^Fms, Gll^Fp, Gs^Fms, Gll^Fp, Gll^Fp, Gll^Fp, Gs, Gll^Fp, Ww, Ww, Hh, Hh^Fp, Hh^Fp, Ms, Hh
Ww, Ww, Ww, Ww, Ww, Ww, Gg, Gg, Gg, Gg, Gg, Gg, Rp, Gg, Gg, Gg, Gs^Fms, Gg^Ve, Gll^Fp, Gll^Fp, Gs, Gll^Fp, Gll^Fp, Gll^Fp, Gs, Gs^Fms, Gs^Fms, Rp, Gs^Fms, Gs, Gll^Fp, Gll^Fp, Gll^Fp, Gs^Fms, Gs^Fms, Gll^Fp, Gs, Gs, Rp, Gll^Fp, Gs^Fms, Gs^Fms, Gll^Fp, Gll^Fp, Gll^Fp, Gll^Fp, Gs^Fms, Gs^Fms, Gll^Fp, Gs^Fms, Gll^Fp, Gs, Ww, Ww, Gs, Gll^Fp, Hh, Hh, Hh, Hh, Gll^Fp
Wo, Wo, Ww, Ww, Ww, Ds, Gg, Gg, Gg, Gg, Gg, Gg, Rp, Gg^Ve, Rd^Gvs, Gg, Gs^Fms, Gll^Fp, Gs^Fms, Gs, Gll^Fp, Gs^Fms, Gs^Fms, Gs^Fms, Gs^Fms, Gs, Rp, Rp, Gll^Fp, Gll^Fp, Gs^Fms, Gll^Fp, Gll^Fp, Gll^Fp, Gs^Fms, Gs, Gs^Fms, Gs, Rp, Gs^Fms, Gll^Fp, Gg^Ve, Gll^Fp, Gll^Fp, Gll^Fp, Gs, Gs^Fms, Gll^Fp, Ww, Gll^Fp, Ww, Ww, Gs, Gll^Fp, Gll^Fp, Gll^Fp, Hh, Gll^Fp, Gs^Fms, Gll^Fp, Gll^Fp
Ww, Ww, Ww, Ww, Ww, Ds, Gg, Gg, Gg^Efm, Gg^Efm, Gg, Gg, Rp, Rd^Gvs, Gg, Gg, Gg, Gll^Fp, Gll^Fp, Gs, Gll^Fp, Gll^Fp, Gs, Gs, Rp, Rp, Gll^Fp, Gll^Fp, Gll^Fp, Gll^Fp, Gs^Efm, Gs^Fms, Gll^Fp, Gll^Fp, Gll^Fp, Gll^Fp, Gg^Fet, Gs^Fms, Rp, Gll^Fp, Gll^Fp, Gll^Fp, Gll^Fp, Gll^Fp, Ww, Gll^Fp, Ww, Ww, Gll^Fp, Ww, Gs, Gs, Gll^Fp, Gll^Fp, Gll^Fp, Gll^Fp, Gll^Fp, Gll^Fp, Gs^Fms, Gll^Fp, Gll^Fp
Ds, Ds, Ww, Ds, Ds, Ds, Gg, Gg, Gg, Gg, Gg, Gg, Rp, Rd^Gvs, Rd^Gvs, Gg, Gg, Gll^Fp, Gg, Gll^Fp, Gll^Fp, Gs, Rp, Rp, Gs, Gs, Gs^Fms, Gs^Es, Gll^Fp, Gg^Ve, Gs, Gs^Fms, Gll^Fp, Gs^Fms, Gs^Fms, Gll^Fp, Gll^Fp, Gll^Fp, Gll^Fp, Rp, Ww, Gll^Fp, Ww, Ww, Gs^Fms, Ww, Gll^Fp, Gs^Fms, Gll^Fp, Gs^Fms, Gs^Fms, Gll^Fp, Gs^Efm, Gll^Fp, Gs^Fms, Gll^Fp, Gll^Fp, Gll^Fp, Gll^Fp, Gll^Fp, Gll^Fp
Gg, Ds, Ce, Ds, Gs, Ce, Gg, Gg, Gg^Ve, Rd^Gvs, Gg, Gg, Gg, Rp, Rp, Gg, Gg, Gg, Gg, Gll^Fp, Gs^Fms, Rp, Gll^Fp, Gll^Fp, Gs, Gll^Fp, Gll^Fp, Gll^Fp, Gll^Fp, Gs, Gs, Gll^Fp, Gll^Fp, Gll^Fp, Gll^Fp, Gll^Fp, Gll^Fp, Gs^Fms, Ww, Ww^Bsb|, Gll^Fp, Ww, Gll^Fp, Gs^Fms, Gs^Fms, Gll^Fp, Gll^Fp, Gll^Fp, Gll^Fp, Gs^Fms, Gll^Fp, Gll^Fp, Gll^Fp, Gll^Fp, Gll^Fp, Gll^Fp, Gg^Fet, Gll^Fp, Gs^Fms, Gs^Fms, Gll^Fp
Gs^Fds, Ce, 5 Ke, Ce, Gs, Ce, Gs, Rd^Gvs, Rd^Gvs, Rd^Gvs, Gg, Gg, Rd^Gvs, Gg, Gg, Rp, Gg, Gg, Gg, Gg, Gll^Fp, Rp, Gs, Gll^Fp, Gll^Fp, Gll^Fp, Gll^Fp, Gll^Fp, Gs^Fms, Gll^Fp, Gll^Fp, Gll^Fp, Gll^Fp, Gs^Fms, Gs^Fms, Gll^Fp, Ww, Ww, Gll^Fp, Rp, Rp, Gs^Fms, Gll^Fp, Cv, Cv, Cv, Gs, Gg^Ve, Gll^Fp, Gll^Fp, Gll^Fp, Gll^Fp, Gll^Fp, Gs^Fms, Gll^Fp, Gs, Gll^Fp, Gll^Fp, Gll^Fp, Gll^Fp, Gll^Fp
Gs^Fds, Ce, Ce, Ce, Gs, Gs, Gs^Fds, Rd^Gvs, Rd^Gvs, Gg, Gg^Efm, Gg, Rd^Gvs, Rd^Gvs, Gg^Ve, Rp, Gg, Gg, Gg, Gll^Fp, Rp, Rp, Gll^Fp, Gll^Fp, Gs^Fms, Gg^Fet, Gs^Fms, Gll^Fp, Gs^Fms, Gll^Fp, Gs^Fms, Gll^Fp, Gll^Fp, Gll^Fp, Ww, Ww, Gll^Fp, Gll^Fp, Gs, Gs^Fms, Cv, Rp, Rp, 2 Kv, Cv, Gs, Gll^Fp, Gll^Fp, Gll^Fp, Gll^Fp, Gs^Fms, Gll^Fp, Gll^Fp, Gs^Fms, Gg^Ve, Gs, Gll^Fp, Gll^Fp, Gll^Fp, Gll^Fp, Gll^Fp
Gs^Fds, Gs, Gs, Gs, Ce, Gs^Fms, Gg, Gg, Gg, Gg, Gg, Gg, Rd^Gvs, Rd^Gvs, Gg, Rp, Rp, Rp, Rp, Rp, Gg, Gg, Gll^Fp, Gs^Fms, Gll^Fp, Gll^Fp, Gll^Fp, Gs, Gll^Fp, Gll^Fp, Gll^Fp, Gll^Fp, Gs^Fms, Gs^Fms, Ww, Gll^Fp, Gll^Fp, Gs, Gs^Fms, Gs, Cv, 1 Kv, Rp, Rp, Gs, Gs, Gs, Gll^Fp, Gll^Fp, Gll^Fp, Gll^Fp, Gll^Fp, Gll^Fp, Gs, Gll^Fp, Gll^Fp, Gs^Fms, Gll^Fp, Gll^Fp, Gs^Fms, Gll^Fp
Gs^Fds, Gs, Gs, Ce, Gg, Gg, Gg, Gg, Rd^Gvs, Rd^Gvs, Rd^Gvs, Gg, Gg, Gg, Gg, Rp, Gg, Gg, Gg, Gg, Gg, Gg, Gg, Gs^Fms, Gll^Fp, Gll^Fp, Gll^Fp, Gs^Fms, Gll^Fp, Gll^Fp, Gll^Fp, Gs^Fms, Gll^Fp, Gll^Fp, Ww, Gll^Fp, Gll^Fp, Gs^Fms, Gll^Fp, Cv, Gs, Cv, Rp, Rp, Gll^Fp, Gll^Fp, Gll^Fp, Gll^Fp, Gll^Fp, Gll^Fp, Gll^Fp, Gll^Fp, Gs^Fms, Gs^Fms, Gll^Fp, Gll^Fp, Gll^Fp, Gll^Fp, Gll^Fp, Gll^Fp, Gll^Fp
Gg, Gs^Fds, Gs, Gg, Gg, Gg, Gs^Fds, Gg, Gg, Gg^Ve, Gg, Gg, Gg, Gg, Rp, Rp, Gg, Gg, Gg, Gg, Gg, Gg, Gg, Gll^Fp, Gll^Fp, Gll^Fp, Gll^Fp, Gll^Fp, Gs, Gg^Ve, Gll^Fp, Gll^Fp, Ww, Ww, Gs^Fms, Gll^Fp, Gll^Fp, Gg^Ve, Gll^Fp, Gs^Fms, Gll^Fp, Gll^Fp, Gll^Fp, Rp, Gll^Fp, Gg^Fet, Gll^Fp, Gll^Fp, Gll^Fp, Gll^Fp, Gll^Fp, Gll^Fp, Gll^Fp, Gs^Fms, Gll^Fp, Gll^Fp, Gll^Fp, Gs^Fms, Gll^Fp, Gs^Fms, Gll^Fp
Gg, Gg, Gg, Gg, Gs^Fds, Gg, Gg, Gg, Gg, Gg, Gg, Gg, Rp, Rp, Gg, Gg, Gg, Gg, Gg, Gg^Efm, Gg, Gg, Gg, Gs^Fms, Gs^Fms, Gll^Fp, Gll^Fp, Gs^Fms, Gs, Gll^Fp, Gll^Fp, Gll^Fp, Ww, Gll^Fp, Gll^Fp, Gll^Fp, Gll^Fp, Gll^Fp, Gll^Fp, Gs, Gs, Gll^Fp, Gg^Ve, Rp, Gll^Fp, Gll^Fp, Gs, Gs, Gs^Fms, Gll^Fp, Gll^Fp, Gs^Fms, Gll^Fp, Gll^Fp, Gs^Fms, Gll^Fp, Gll^Fp, Gll^Fp, Gs^Fms, Gll^Fp, Gll^Fp
Gg, Gg, Gg, Gg, Gs^Fds, Gs^Fms, Gs^Fds, Gg, Gg, Gg, Gg, Rp, Gg, Gg, Gg, Gg, Gg, Gg, Gg, Gg, Gg, Gg, Gg, Gs^Fms, Gg, Gll^Fp, Gll^Fp, Gll^Fp, Gs^Fms, Gll^Fp, Ww, Ww, Gll^Fp, Gs^Fms, Gll^Fp, Gs^Fms, Gll^Fp, Gll^Fp, Gs, Gs, Gll^Fp, Gll^Fp, Gll^Fp, Rp, Gs, Gs, Gs, Gs^Fms, Gll^Fp, Gll^Fp, Gll^Fp, Gll^Fp, Gll^Fp, Gs, Gg^Ve, Gll^Fp, Gll^Fp, Gll^Fp, Gll^Fp, Gs^Fms, Gll^Fp
Ww, Ww, Ww, Gg, Gg, Gg, Gg, Gg, Gg, Gg, Gg, Rp, Gg, Gg, Gg, Gg, Gg, Gg, Gg, Gg, Gll^Fp, Gll^Fp, Gll^Fp, Gg, Gg, Gg, Gll^Fp, Gs^Fms, Ww, Ww, Gll^Fp, Gll^Fp, Gll^Fp, Gs^Fms, Gll^Fp, Gs^Fms, Gll^Fp, Gs, Gs^Fms, Gs, Gs^Fms, Gll^Fp, Rp, Rp, Gs, Gs, Gll^Fp, Gll^Fp, Gll^Fp, Gs^Fms, Gs^Fms, Gll^Fp, Gs, Gs, Gs, Gs^Fms, Gll^Fp, Gs^Fms, Gll^Fp, Gs^Fms, Gll^Fp
Gg, Gg, Gg, Ww, Gg, Gg, Gg, Gg, Gg, Gg, Gg, Rp, Rp, Gg, Ww, Ww, Ww, Ww, Ww, Gg, Gll^Fp, Gll^Fp, Gll^Fp, Gll^Fp, Gg, Gs^Fms, Gll^Fp, Gs^Fms, Ww, Gs^Fms, Gll^Fp, Gll^Fp, Gll^Fp, Gg^Fet, Gll^Fp, Gs^Fms, Gs, Gll^Fp, Gll^Fp, Gs^Fms, Rp, Rp, Gs^Efm, Rp, Rp, Gg^Ve, Gll^Fp, Gll^Fp, Gs^Fms, Gll^Fp, Gll^Fp, Gll^Fp, Gs, Gs^Fms, Gll^Fp, Gll^Fp, Gll^Fp, Gll^Fp, Gll^Fp, Gll^Fp, Gll^Fp
Gs^Fms, Gs^Fms, Gg, Ww, Ww, Ww, Ww, Gg, Gg, Gg, Gg, Gg, Gg, Ww^Bsb\, Rp, Gg, Gg, Gg, Gg, Ww, Ww, Ww, Ww, Gll^Fp, Ww, Gg, Ww, Ww, Gll^Fp, Gll^Fp, Gs, Gs, Gll^Fp, Gll^Fp, Gs, Gll^Fp, Gll^Fp, Gll^Fp, Gll^Fp, Rp, Gs^Efm, Gs, Gs, Gs, Rp, Gll^Fp, Gll^Fp, Gll^Fp, Gll^Fp, Gll^Fp, Gll^Fp, Gll^Fp, Gll^Fp, Gll^Fp, Gll^Fp, Gll^Fp, Gll^Fp, Gll^Fp, Gll^Fp, Gs^Fms, Gll^Fp
Gg, Gs^Fms, Rd^Gvs, Gg, Gs^Fds, Gs^Fds, Gs^Fds, Ww, Gg, Gg, Gg, Gg, Ww, Ww, Ce, Rp, Rp, Ce, Gs, Gg, Gg, Gg, Gg, Ww, Gg, Ww, Gs^Fms, Gll^Fp, Gll^Fp, Gg^Ve, Gs, Gs, Gll^Fp, Gll^Fp, Gll^Fp, Gs, Gll^Fp, Gll^Fp, Rp, Rp, Gll^Fp, Gll^Fp, Gs^Fms, Gll^Fp, Rp, Gll^Fp, Gll^Fp, Gll^Fp, Gs^Fms, Gll^Fp, Gll^Fp, Gll^Fp, Gll^Fp, Gll^Fp, Gll^Fp, Gll^Fp, Gll^Fp, Gll^Fp, Gll^Fp, Gll^Fp, Gll^Fp
Gg, Gg, Rd^Gvs, Gg^Ve, Gs^Fds, Gg, Gs^Fds, Ww, Ww, Ww, Ww, Ww, Gs, Ce, 4 Ke, Ce, Rp, Ce, Gs, Gs, Gs, Gg, Gg, Gg, Gg, Gg, Gg, Gll^Fp, Gll^Fp, Gs, Gll^Fp, Gs^Fms, Rp, Rp, Rp, Gs^Es, Rp, Rp, Gs, Gll^Fp, Gll^Fp, Gs^Fms, Gll^Fp, Gll^Fp, Rp, Gll^Fp, Gll^Fp, Gll^Fp, Gll^Fp, Gll^Fp, Gll^Fp, Gs^Fms, Gll^Fp, Gll^Fp, Gll^Fp, Gs^Fms, Gll^Fp, Gg^Ve, Gll^Fp, Gll^Fp, Gs^Fms
Rp, Rp, Rp, Rp, Rp, Gg, Gg, Gs^Fds, Gg, Gg, Gs, Gs, Gs, Ce, Ce, Ce, Rp, Rp, Rp, Rp, Rp, Gg, Gg, Gg, Gg, Gg, Gg, Gg, Gs^Fms, Gs^Fms, Rp, Rp, Gs^Fms, Gll^Fp, Gll^Fp, Rp, Gs, Gs, Gg^Ve, Gll^Fp, Gll^Fp, Gll^Fp, Gll^Fp, Gll^Fp, Gll^Fp, Rp, Rp, Gll^Fp, Gll^Fp, Gll^Fp, Gll^Fp, Gs^Fms, Gll^Fp, Gs^Fms, Gll^Fp, Gll^Fp, Gs, Gs^Fms, Gll^Fp, Gll^Fp, Gll^Fp
Gg, Gg, Gg, Gg, Gg, Rp, Rp, Gg, Rp, Gg^Ve, Rp, Gs, Rp, Rp, Rp, Rp, Gg, Gs, Gg, Gg, Gg, Rp, Rp, Rp, Rp, Rp, Rp, Gg, Rp, Rp, Gs^Fms, Gs^Fms, Gs^Efm, Gll^Fp, Gll^Fp, Gs, Gll^Fp, Gll^Fp, Gll^Fp, Gll^Fp, Gll^Fp, Gll^Fp, Ce, Ce, 3 Ke, Ce, Ce, Rp, Gll^Fp, Gll^Fp, Gs^Fms, Gs, Gll^Fp, Gg^Fet, Gs^Fms, Gll^Fp, Gs, Gll^Fp, Gs^Fms, Gll^Fp, Gll^Fp
Gg, Gg, Gg, Gg^Efm, Gg, Gg, Gg, Rp, Gg, Rp, Gg, Rp, Gg, Gg, Gg, Gg^Ve, Gg, Gg, Gg, Gg, Gg, Gg, Gg, Gg, Gg, Gg, Gg, Rp, Gg, Gg, Gg, Gll^Fp, Gll^Fp, Gg^Ve, Gll^Fp, Gs, Gll^Fp, Gll^Fp, Gll^Fp, Gll^Fp, Gs, Gll^Fp, Gs^Fms, Ce, Gll^Fp, Ce, Gll^Fp, Rp, Gll^Fp, Gll^Fp, Gll^Fp, Gll^Fp, Gs^Fms, Gll^Fp, Gll^Fp, Gs, Gs^Fms, Gll^Fp, Gll^Fp, Gll^Fp, Gll^Fp
Gg, Gg, Gg, Gg, Gg, Gg, Gg, Gg, Gg, Gg, Gg, Gg, Gg, Gg, Gg, Gg, Gg, Gg, Gg, Gg, Gg, Gg, Gg, Gg, Gg, Gg, Gg, Gg, Gg, Gg, Gg, Gg, Gll^Fp, Gs^Fms, Gs^Fms, Gs^Fms, Gll^Fp, Gll^Fp, Gll^Fp, Gs, Gs, Gs, Gll^Fp, Gll^Fp, Gll^Fp, Gll^Fp, Gll^Fp, Rp, Gll^Fp, Gs^Fms, Ww, Gll^Fp, Gll^Fp, Gs, Gs, Gs, Gs, Gs, Gll^Fp, Gll^Fp, Gll^Fp
