Hh, Hh, Hh, Hh^Fp, Hh^Fp, Hh^Fp, Hh, Hh, Hh^Fp, Hh^Fp, Hh^Fp, Hh^Fp, Hh, Hh, Rd, Hh, Hh, Hh^Fp, Hh^Fp, Hh^Fp, Hh^Fp, Hh^Fp, Hh^Fp, Hh, Hh^Fmw, Ha, Ms, Hh, Ms, Ms, Ms, Wo, Ms, Ms, Ms, Ms, Ms, Ms, Ms, Ms, Ms, Ms, Ms, Ms, Ms, Ms, Ms, Ms, Hh, Gll^Fp, Gll^Fp, Hh, Hh^Fp, Gll^Fp, Hh^Fp, Hh^Fp, Gll^Fp, Gll^Fp, Gll^Fp, Gll^Fp, Gll^Fp, Gll^Fp
Hh, Hh, Hh^Fp, Hh, Hh, Hh, Hh^Fp, Hh, Hh, Hh^Fp, Gs^Ve, Hh^Fp, Hh, Hh, Hh, Rd, Hh, Hh, Hh^Fp, Hh^Fp, Hh^Fp, Hh^Fp, Hh, Hh, Ha, Ha, Ha, Ms, Ms, Ms, Wwr, Wo, Ms, Ms, Ms, Ms, Ms^Vea, Ms, Ms, Ms, Ha, Ms, Ms, Ha, Ms, Ms, Hh, Hh, Hh, Hh, Gll^Fp, Hh^Fp, Gll^Fp, Gll^Fp, Gll^Fmw, Gll^Fmw, Gll^Fp, Gll^Fp, Gll^Fmw, Gll^Fp, Gll^Fp, Gll^Fp
Hh^Fp, Hh^Fp, Hh^Fp, Hh, Ds^Esd, Hh^Fp, Hh^Fmw, Hh, Hh, Hh, Hh, Hh, Rd, Rd, Rd, Rd, Gd^Fp, Hh, Hh, Gd^Fp, Gd^Fmw, Hh^Fp, Hh, Hh^Fmw, Hh, Hh, Hh^Fmw, Hh, Ha, Ha^Fmw, Ha^Vea, Wo, Wo, Wwr, Ms, Ms, Ms, Ms, Ms, Ha, Hh, Ms, Ms, Hh, Hh, Hh, Hh^Fp, Hh^Fp, Gll^Fp, Hh^Fp, Gll^Fmw, Gll^Fmw, Gll^Fp, Gll^Fp, Gll^Fp, Gll^Fp, Rrc, Gll^Fp, Rrc, Rrc, Rrc, Rrc
Ww, Hh^Fp, Hh^Fp, Ds^Esd, Ds^Esd, Hh, Hh^Fp, Hh^Fp, Hh^Fp, Hh^Fp, Hh, Rd, Hh^Fp, Hh^Fp, Hh^Fp, Gd^Fp, Gll^Fp, Hh, Hh, Gd^Fp, Hh, Hh^Fp, Hh, Hh, Hh^Fp, Hh^Fp, Hh^Fp, Hh^Fp, Ha^Fmw, Ha^Fmw, Wwr, Wo, Hh^Fp, Ha, Hh^Fms, Ha, Ha^Fp, Ha, Ha^Fms, Ms, Hh^Fp, Hh^Fp, Hh^Fp, Hh^Fp, Hh^Fp, Gll^Fp, Gll^Fp, Hh^Fp, Gll^Fp, Gll^Fp, Rrc, Gll^Fp, Rrc, Rrc, Rrc, Rrc, Hh^Fms, Rrc, Hh, Hh^Fms, Hh^Fms, Hh^Fds
Ww, Wwr, Ds, Ds, Hh^Fp, Hh, Hh^Fp, Hh, Gd^Fp, Hh, Hh, Rd, Hh, Hh^Fp, Hh^Fp, Hh^Fms, Gll^Fp, Gll^Fp, Gd^Fp, Gd^Fp, Gd^Fp, Gd^Fp, Gll^Fp, Hh, Hh, Hh^Fp, Gll^Fp, Gd^Fms, Ww, Wwr, Hh^Fds, Wwr, Hh^Fp, Hh^Fds, Hh, Ha^Fp, Hh^Fp, Hh^Fms, Hh^Fms, Hh^Fp, Gll^Fp, Hh^Fp, Gll^Fp, Hh^Fp, Gll^Fp, Gll^Ve, Rrc, Gll^Fp, Rrc, Rrc, Gs^Fp, Rrc, Gs^Fms, Gs^Fms, Gg^Ve, Gs^Fms, Hh^Fms, Hh^Fms, Hh^Fms, Hh^Fds, Hh^Fms, Hh^Fds
Ww, Wwr, Wwr, Ds, Ds, Hh^Fp, Gd^Fp, Hh, Gll^Fp, Hh, Rd, Rd, Hh, Hh^Fp, Hh, Gd^Fp, Gd^Fmw, Hh, Hh, Hh^Fmw, Hh^Fp, Hh^Fp, Hh^Fp, Gll^Fp, Gd^Fms, Hh^Fp, Hh^Fp, Gd^Fp, Ww, Hh^Fds, Hh^Fmw, Hh, Hh^Fds, Hh^Fp, Hh^Fp, Hh^Fms, Hh^Fp, Hh^Fms, Gll^Fp, Hh^Fms, Gd^Fetd, Gll^Fmw, Gll^Fmw, Gll^Fp, Rrc, Rrc, Gs^Fms, Rrc, Gs^Fp, Gs^Fms, Gs^Fms, Gs^Fp, Gs^Fms, Gs^Fms, Gs^Fms, Gs^Fms, Gs^Fms, Hh^Fds, Hh, Hh, Hh^Fms, Hh^Fds
Ww, Wwr, Wwr, Wwr, Ds, Hh^Fp, Hh^Fms, Gd^Fmw, Gd^Fp, Rd, Hh, Hh, Hh^Fp, Hh, Hh, Gd^Fp, Gd^Fp, Hh^Fp, Hh, Gd^Fp, Gd^Fp, Hh^Fp, Hh^Fp, Hh^Fp, Gd^Fp, Hh^Fp, Ww, Hh^Fp, Wwr, Hh^Fp, Hh^Fp, Hh^Fp, Hh^Fds, Hh^Fms, Hh^Fp, Hh^Fmw, Hh^Fp, Hh^Fms, Gll^Fp, Gll^Fp, Gll^Fp, Gll^Fp, Gll^Fp, Rrc, Gs^Fms, Gs^Fms, Gs^Fms, Gs^Fp, Gs^Fms, Gs^Fms, Gs^Fp, Gs^Fms, Hh, Gs^Fms, Hh^Fds, Hh^Fds, Hh, Hh, Hh^Fds, Hh, Hh^Fms, Hh
Ww, Ww, Ww, Wwr, Ww, Hh^Fp, Hh^Fp, Gd^Fp, Gd^Fp, Rd, Rd, Gd^Es, Gd^Es, Gd^Es, Hh^Fp, Hh, Hh, Hh, Hh, Gd^Fp, Gll^Fp, Hh^Fp, Gs^Ve, Hh^Fp, Hh^Fp, Gd^Fp, Ww, Wwr, Hh^Fds, Wwr, Hh^Fds, Hh^Fds, Hh^Fms, Hh, Gs^Fds, Hh^Fp, Hh^Fms, Hh^Fms, Hh^Fms, Hh^Fms, Hh^Fms, Hh^Fms, Rrc, Rrc, Gs^Fms, Gs^Fms, Gg^Fet, Gs^Fp, Gs^Fp, Gs^Fp, Gs^Fp, Gs^Fms, Gs^Fms, Hh^Fds, Hh^Fds, Hh, Hh^Fms, Hh^Fms, Gs^Fms, Gs^Fds, Hh^Fds, Hh
Ds, Ww, Ww, Ww, Ww, Wwr, Ww, Hh, Gd, Gd, Rd, Gd^Ve, Hh^Fp, Hh^Fms, Hh^Fp, Hh^Fp, Hh, Hh^Fet, Hh, Hh^Fp, Gll^Fp, Gd^Efm, Hh, Hh^Fp, Hh, Ww, Ww, Gs^Fds, Gs^Ve, Hh^Fms, Hh^Fp, Hh^Fds, Hh, Gs^Fms, Hh^Fds, Gs^Fds, Hh, Hh^Fds, Hh^Fmw, Hh^Fms, Hh, Rrc, Gs^Fms, Gs^Fms, Gs^Fp, Gs^Fms, Gs^Fms, Gs^Fms, Gs^Fms, Gs^Fms, Hh^Fds, Gs^Fms, Hh^Fds, Hh^Fds, Gs^Fp, Hh^Fds, Hh^Fds, Gs^Fms, Ww, Ww, Ww, Hh^Fds
Ds, Ww, Wwr, Ww, Ww^Vm, Wwr, Ww, Ds, Ds, Gll^Fp, Gd, Rd, Hh, Hh^Fp, Hh^Fp, Hh^Fp, Hh^Fp, Hh^Fp, Hh^Fp, Hh^Fp, Hh^Fms, Gd^Fp, Hh^Fp, Hh^Fp, Hh^Fms, Hh^Fp, Ww, Gs^Fds, Wwf, Gs^Gvs, Hh^Fms, Wwr, Gs^Fp, Gs^Fds, Hh^Fds, Hh^Fp, Hh^Fp, Hh^Fp, Hh^Fds, Hh^Fms, Hh^Fms, Rrc, Gs^Fms, Gs^Fp, Gs^Fms, Gs^Fms, Hh^Fds, Gs^Fms, Gs^Fms, Hh^Fds, Hh^Fp, Hh^Fds, Gs^Fp, Hh^Fds, Gs^Fds, Ww, Ww, Gs^Fds, Wo, Ww, Ww, Ww
Gs^Fms, Ds, Wwr, Ww, Ww, Ww, Ww, Ww, Ww, Gd, Ds, Rd, Rd, Gd, Gd, Hh, Hh, Gd^Fp, Gd^Fp, Gd^Fms, Gd^Fp, Gll^Fp, Hh^Fms, Hh, Hh^Fms, Gs^Fms, Ww, Ww, Gs^Fms, Wwrg, Ww, Wwr, Hh^Fds, Gs^Fp, Gs^Fms, Gs^Fp, Gs^Fds, Gs^Fms, Gs^Fms, Gs^Fds, Gs^Fds, Rrc, Rra, Gs^Fp, Gs^Fms, Gs^Fms, Hh^Fds, Gs^Fms, Hh, Hh, Hh^Fds, Hh^Fp, Gs^Fp, Gs^Fms, Ww, Wwr, Wo, Ww^Vm, Ww, Ww, Gs^Fds, Hh^Fds
Gs^Fms, Gs, Gs, Wwr, Gs^Fms, Ww, Ww, Ww, Ww, Ww, Ds, Ds, Rd, Gd, Hh, Hh, Hh, Gd, Gd^Efm, Gd, Gd^Efm, Gd^Fp, Hh^Fms, Hh, Wwr, Wwr, Gs^Fms, Ww, Gs^Fds, Gs^Fms, Hh^Fds, Hh, Hh^Fp, Gs^Fms, Hh, Gs^Fms, Hh, Gs^Fds, Hh^Fms, Gs^Fds, Gs^Fds, Gs^Fds, Rrc, Gs^Fms, Hh^Fds, Hh^Fds, Hh, Hh^Fds, Gs^Fms, Hh^Fds, Gg^Ve, Gs^Fp, Gs^Fms, Gs^Fds, Wwr, Wwr, Wo, Wo, Wwr, Gs^Fds, Gs^Fms, Gs^Fms
Gs, Gs, Gs, Gs^Fms, Gs^Fms, Ds, Ww, Ww, Ww, Ww, Wwf^Es, Wwf^Es, Rd, Gd, Gd, Gd, Gd, Gd, Gd, Gd^Efm, Hh^Fp, Hh^Fms, Hh^Fp, Hh^Fp, Wwr, Ww, Gs^Fms, Gs^Fds, Hh^Ve, Hh^Fds, Hh, Hh, Hh^Fms, Hh, Gs^Fds, Gs^Fds, Gs^Gvs, Hh^Fp, Gs^Fp, Gs^Fds, Gs^Fds, Gs^Ve, Rrc, Hh^Fds, Gs^Fms, Hh, Hh^Fms, Hh, Hh^Fds, Gs^Fds, Gg^Efm, Gs^Fds, Gs^Fms, Ww, Ww, Ww, Wwr, Gs^Fds, Gs^Fds, Gs^Fds, Hh^Fms, Hh^Fms
Gs, Gs, Gs^Fds, Gs, Gs, Ds, Ds, Ww, Ww, Ww, Wwf^Es, Wwf^Es, Wwf^Es, Rd, Rd, Gd, Gd, Gd, Rd, Gd, Gd, Gd, Gd, Hh^Fms, Ww, Gs^Fds, Gs^Fds, Gs^Fds, Hh^Fms, Hh^Fds, Hh^Fds, Hh^Fds, Gs^Fms, Hh^Fds, Hh^Fms, Gs^Ve, Rp, Gs^Fp, Gd^Fms, Gd^Fds, Rrc, Rrc, Gs^Fms, Gg, Gg^Efm, Hh^Fds, Gs^Fms, Hh, Hh^Fms, Hh^Fds, Gg^Fet, Gs^Fms, Gs^Fms, Gs^Fds, Ww, Hh^Fds, Hh^Fds, Hh, Hh, Hh^Fds, Hh^Fms, Hh^Fms
Gs, Gs, Gs^Fds, Gs^Fds, Gs, Gs^Fms, Gs, Ww, Wwf^Es, Wwf^Es, Wwf^Es, Wwf^Es, Ww, Wwf^Es, Ww, Rd, Rd, Rd, Gd, Rd, Rd, Gd^Ve, Ww, Wwr, Gs^Fds, Ww, Gs^Fds, Gs^Fds, Hh, Hh^Fds, Hh^Fds, Gs^Fms, Gs^Fms, Hh, Hh^Fds, Rp, Gs^Fds, Gd^Fds, Gd^Fms, Rrc, Gs^Fds, Gs^Fms, Gs^Fds, Gs^Fds, Gg, Gs^Fds, Hh^Fds, Hh, Gs^Fms, Gs^Fds, Hh^Fds, Hh^Fds, Gs^Fds, Ww, Hh^Fds, Hh^Fds, Hh, Hh, Mm^Ve, Hh^Fds, Hh, Hh^Fds
Gs^Fds, Gs^Fds, Gs^Fds, Gs^Fms, Gs^Fms, Gs, Gs^Efm, Gs, Rd, Wwf^Es, Wwf, Wwf^Es, Ww, Ww, Ww, Gd^Fp, Gd^Fp, Gd^Fp, Gd^Fms, Gd^Fp, Gd^Fms, Ww^Bw\, Rd, Ww, Gs^Fds, Gs^Fds, Gs^Fds, Hh^Fms, Hh^Fms, Gs^Fms, Gs^Fds, Gs^Fds, Gs^Fms, Gs^Fds, Gs^Fds, Rp, Gs^Ve, Gd^Fds, Rrc, Rrc, Gs^Fds, Gs^Fms, Gs^Fds, Gs^Fp, Gs^Fp, Gs^Fds, Hh^Fds, Gs^Fds, Gs^Fp, Gs^Fp, Hh^Fms, Hh^Fms, Gs^Fds, Gs^Fds, Hh^Fms, Hh, Hh^Fms, Mm, Mm, Mm, Hh, Hh^Fds
Gs^Fds, Gs^Fds, Gs^Fms, Gs^Fms, Gs^Fms, Gs^Fds, Gs, Gs, Rd, Gs, Ds, Wwf, Ww, Wo, Wo, Ww, Gd^Fms, Gd^Fp, Ww, Gd^Fms, Ww, Ww, Rd, Gs^Fms, Gs^Fds, Gs^Fds, Gs^Fds, Gs^Fms, Hh^Fp, Gs^Fds, Gs^Fms, Gs^Fms, Gs^Fds, Gs^Fds, Rrc, Rrc, Rrc, Rrc, Gs^Fds, Gs^Fds, Gs^Fds, Gs^Fds, Gs^Fds, Gs^Fp, Gs^Fms, Hh^Fds, Wwr, Hh, Hh^Fds, Gs^Fp, Hh^Fds, Hh^Fds, Hh^Fms, Hh^Fms, Hh^Fms, Hh^Fds, Hh^Fms, Hh^Fds, Hh^Fds, Hh, Hh^Fds, Hh
Gs^Fds, Gs^Fds, Gs^Fds, Gs^Fds, Gs^Fds, Gs^Fms, Gs^Fms, Gs, Rd, Gs, Gs, Ds, Ww, Wo, Wwr, Ww, Ww, Ww, Ww, Ww, Gs^Fds, Ww, Rd, Gd^Fms, Gs^Fms, Gs^Fds, Gs^Fms, Gs^Fms, Gs^Fds, Gs^Fds, Gs^Fms, Gs^Fms, Gs^Fds, Gs^Fds, Rrc, Gs^Fds, Gs^Fds, Gs^Fds, Gs^Fms, Gs^Fms, Gs^Fet, Gs^Fds, Gs^Fds, Gs^Fms, Gs^Fds, Wwr, Ww, Wwr, Hh^Fds, Hh^Fds, Hh^Fds, Hh, Hh, Hh^Fds, Hh^Fds, Hh, Gs^Fds, Hh^Fms, Gs^Fms, Gs^Fds, Hh, Hh^Fds
Gs^Fds, Gs^Fds, Gs^Fms, Gs^Fds, Gs^Fds, Gs^Fms, Gs^Fms, Gs, Gs, Rd, Rd, Gs, Rd, Ww, Ww, Wo, Wo, Ww, Gs^Fds, Gs^Fms, Gs^Fms, Gs^Fds, Rd^Es, Gd^Fds, Gd^Fds, Gs^Fms, Gs^Fms, Gs^Fds, Gs^Fds, Gs^Fms, Gs^Fms, Gs^Fms, Gs^Ve, Gd^Fds, Rrc, Gs^Fds, Gs^Fms, Gs^Fds, Gs^Fds, Gs^Efm, Gs^Fms, Gs^Efm, Gs^Fds, Gs^Fds, Gs^Fds, Gg^Efm, Wwf^Es, Hh^Fds, Hh^Fds, Hh, Hh, Hh, Hh^Fds, Hh^Fds, Hh^Fds, Gs^Fds, Gs^Fds, Gs^Fms, Gs^Fms, Gs^Fms, Gs^Fms, Hh^Fds
Gs^Fms, Gs^Fds, Gs^Fms, Gs^Fds, Gs^Fms, Gs^Fms, Gs^Fds, Gs^Fms, Gs^Fds, Gs, Gs^Fds, Rd, Gs^Ve, Rd, Ww, Wo, Wo, Ww, Gs^Fds, Gs^Fds, Gs^Fds, Gs^Es, Gd^Fds, Re^Vhs, Gd^Fds, Gd^Fms, Gs^Fds, Gd^Fet, Gs^Fds, Gs^Fds, Gs^Fds, Gd^Fms, Gd^Fds, Rp, Rrc, Rp, Rp, Gs^Fms, Gs^Fds, Gs^Fds, Gs^Fds, Gs^Fms, Gs^Ve, Gs^Fds, Gs^Fds, Gs^Fds, Wwf^Es, Wwf^Es, Gs^Fds, Hh^Fds, Hh, Hh, Hh^Fds, Hh, Gs^Fds, Gs^Fds, Gs^Fp, Gs^Fms, Gs^Fds, Gs^Fms, Gs^Fms, Hh^Fms
Hh, Gs^Fms, Gs^Fms, Gs^Fms, Gs^Fms, Gs^Fms, Hh, Gs^Fds, Gs^Fds, Gs^Fms, Gs^Fds, Gs^Fds, Gs^Fds, Rd, Gs^Fds, Wo, Wo, Wo, Ww, Ww, Gs^Fds, Gs^Fds, Gd^Fms, Gd^Fds, Gs^Fp, Gs^Fms, Hh^Fds, Gs^Fds, Gs^Fds, Gs^Fms, Gs^Fds, Gd^Fds, Rrc, Rrc, Gd^Fds, Gs^Vhs, Rp, Gs^Fds, Gd^Fds, Gs^Fms, Gs^Fds, Gs^Gvs, Re, Gs^Gvs, Wwf, Wwf, Wwf, Gs^Fds, Gs^Fds, Hh^Fds, Hh^Fds, Hh^Fds, Hh^Fds, Gs^Fds, Gs^Fds, Gs^Fp, Gs^Fp, Gs^Fds, Gs^Fds, Gs^Fds, Gs^Fp, Gs^Fms
Mm, Hh, Mm, Hh, Hh, Hh, Hh, Gs^Fds, Hh, Gs^Fds, Gs^Fms, Gs^Fds, Rd, Rd, Gs^Fds, Ww, Wo, Wo^Es, Wo^Es, Ww, Wwr, Gd^Fds, Gd^Fds, Gd^Fp, Gs^Fms, Gs^Fds, Hh^Fds, Gs^Fds, Hh^Fds, Gs^Fms, Gs^Fds, Rrc, Gs^Fds, Gs^Fds, Gd^Fds, Gd^Fds, Rp, Gd^Fds, Gs^Gvs, Gs^Fds, Re, Re, Gs, Re, Wwf, Re, Re, Gs^Fds, Gs^Fds, Hh^Fds, Gs^Fds, Hh^Fds, Gg, Gg^Ve, Gs^Fds, Gs^Fms, Gs^Fds, Gs^Fds, Hh^Fms, Gs^Fms, Gs^Fp, Gs^Fp
Mm, Mm, Mm, Hh, Hh, Mm, Hh, Hh, Gs^Fds, Gs^Fds, Gs^Fds, Gs^Fms, Rp, Gs^Fds, Gs^Fms, Gs^Fds, Ww, Ww, Wwr^Es, Wwr^Es, Wo, Gs^Fds, Gs^Fds, Gs^Fms, Gs^Fms, Hh^Fms, Hh^Fds, Hh^Fds, Hh^Fms, Gs^Fms, Rrc, Rrc, Gs^Fds, Gs^Fds, Gs^Fms, Gd^Fds, Gd^Fds, Rp, Gd^Fds, Gd^Ve, Gs^Fds, Gs^Fds, Wwf, Wwf, Gs^Fms, Gs^Fds, Gs^Fms, Gs^Fds, Gs^Fms, Gs^Fds, Gg^Fet, Gg^Efm, Gs^Fms, Gs^Fds, Gs^Fms, Hh^Fds, Hh, Hh, Gs^Fms, Gs^Fms, Gs^Fp, Gs^Fp
Mm, Mm, Hh^Fms, Hh, Gs^Fms, Hh, Hh, Gs^Fms, Gs^Fds, Gg^Fet, Gs^Fds, Gs^Fds, Rp, Gs^Fms, Gs^Fms, Gs^Fds, Gs^Fds, Gs^Fds, Ww, Wo^Es, Wo^Es, Gs^Ve, Ww, Gs^Fds, Gs^Fds, Hh^Fds, Hh^Fds, Gg^Ve, Gs^Fms, Gs^Fds, Rrc, Gs^Fds, Gs^Fds, Gg^Ve, Gs^Fds, Gs^Fds, Gs, Re, Gs^Gvs, Gd^Fds, Gd^Fds, Gs^Fds, Wwf, Gs^Fms, Gs^Fds, Gs^Fds, Gs^Fds, Gs^Fms, Gs^Fds, Gs^Fms, Gs^Fds, Gs^Fds, Hh^Fds, Hh^Fms, Hh^Fds, Hh^Fds, Hh^Fds, Hh^Fds, Gs^Fds, Gs^Fms, Gs^Fms, Gs^Fms
Hh, Hh, Gs^Fms, Gs^Fms, Gg, Gs^Fms, Gs^Fms, Gs^Fms, Gs^Fds, Gs^Fds, Gs^Fds, Rp, Gs^Fds, Gs^Fds, Gs^Fds, Gs^Fds, Gg^Efm, Gs^Fds, Gs^Fds, Wo^Es, Wwr^Es, Wwr^Es, Wo^Es, Ww, Hh^Fds, Hh^Fds, Gs^Vhs, Gs^Fds, Gs^Fds, Gs^Fds, Rrc, Gs^Fds, Gs^Fds, Gs^Fms, Gs^Fds, Gs^Fms, Gs^Fds, Rp, Gs^Ve, Gs^Gvs, Gd^Fds, Gd^Fds, Wwf, Gs^Fds, Gs^Fds, Gs^Fds, Gs^Fms, Gs^Fds, Hh^Fds, Gs^Fds, Hh^Fds, Gs^Fds, Hh, Hh, Hh, Hh, Hh^Fds, Hh^Fds, Gs^Fds, Gs^Fds, Gs^Fms, Gs^Fds
Hh, Gs^Fms, Gs^Fms, Gg, Gg^Ve, Gg^Efm, Gg, Gs^Fms, Gs^Fds, Gs^Fds, Gs^Fds, Rp, Gs^Fds, Gs^Fds, Gs^Fds, Gg^Efm, Gg^Fet, Gs^Fds, Gs^Fds, Wwr^Es, Ww^Es, Wo^Es, Wo^Es, Ww, Gs^Fds, Gs^Fds, Gs^Fds, Gs^Fds, Gs^Fds, Ww, Ww^Bsb|, Ww, Gs^Fds, Gs^Fds, Gs^Fds, Gs^Fms, Gs^Fp, Rp, Rp, Rp, Wwf, Wwf, Gs^Fds, Gs^Fms, Gs^Fms, Gs^Fds, Gs^Fms, Gs^Fds, Gs^Fds, Hh^Fds, Hh^Fms, Hh^Fds, Gs^Fds, Hh^Fds, Gs^Fds, Hh^Fds, Gs^Fds, Gs^Fds, Gs^Fds, Gs^Fds, Gs^Fds, Gs^Fms
Gs^Fds, Gs^Fds, Gs^Fms, Gs^Fds, Gs^Fms, Gs^Fms, Gs^Fds, Gs^Ve, Gg, Gs^Fds, Rp, Rp, Rp, Gs^Fds, Gs^Fds, Gg^Em, Gs^Fds, Gs^Fds, Gs^Fds, Gs^Fds, Gs^Fds, Wo^Es, Wwr^Es, Wwr^Es, Wo, Gs^Fds, Gs^Fds, Ww, Ww, Ww, Ww^Bsb|, Ww, Ww, Ww, Gs^Fds, Gs^Fms, Wwf, Gs^Fds, Wwf, Wwf^Bw\, Rp, Gd^Fds, Gs^Fds, Gs^Fds, Gs^Fms, Gs^Fms, Gs^Fds, Gs^Fds, Gs^Fds, Gs^Fds, Hh^Fds, Hh^Fms, Gs^Fms, Gs^Fds, Gs^Fds, Hh^Fms, Hh^Fds, Gs^Fds, Gs^Fds, Gg^Vhs, Gs^Fds, Gs^Fms
Gs^Fds, Gs^Fds, Gs^Fds, Gs^Fms, Gs^Fds, Gs^Fds, Gs^Fds, Gg^Efm, Gs^Fds, Rp, Hh^Fds, Hh, Gs^Fds, Rp, Rp, Gg^Ve, Gs^Fds, Gs^Fds, Gs^Fds, Gg^Gvs, Gs^Ve, Wwr^Es, Wo, Wo^Es, Wo^Es, Gs^Fds, Ww, Ww, Ww, Cv^Fet, Rp, Cv^Fet, Ww, Ww, Ww, Wwf, Gs^Fds, Wwf, Gs^Fds, Gs^Fds, Rp, Gs^Fds, Gs^Gvs, Gd^Fms, Gs^Fds, Gs^Fds, Gs^Fds, Gs^Fds, Gs^Fds, Hh^Fds, Hh^Fds, Hh^Fds, Gs^Fms, Gs^Fds, Gs^Fms, Gs^Fms, Gs^Fds, Gs^Fds, Gs^Fds, Gs^Fds, Gs^Fp, Gs^Fp
Gs^Fds, Gs^Fds, Cv, Gs^Fds, Gs^Fms, Gs^Fds, Gg, Gg^Efm, Gs^Fds, Gs^Fds, Hh, Hh, Hh, Gs^Fds, Rp, Gs^Fds, Rp, Gs^Fds, Rp, Rp, Gs^Fds, Gs^Fds, Gs^Fds, Wo^Es, Ww, Ww, Ww, Ww, Cv, Cv, Gs, Cv, Cv, Ww, Ww, Ww, Gs^Fds, Gs^Fds, Gs^Fds, Gs^Gvs, Gs^Ve, Rp, Gd^Fds, Gs^Fds, Gs^Fds, Gs^Fds, Gs^Vhs, Gs^Fds, Gs^Fds, Gs^Fms, Gs^Fds, Gs^Fds, Gs^Fms, Gs^Fms, Gs^Fds, Gs^Fds, Gs^Fds, Gs^Fds, Gs^Fms, Gs^Fms, Gs^Fp, Gs^Fp
Gs^Fds, Gs^Fds, Cv, Cv, Cv, Gg^Em, Gs^Fms, Gs^Fds, Gg^Fet, Gs^Fds, Hh^Fds, Hh, Mm, Hh, Hh, Rp, Hh^Fds, Rp, Rp, Gs^Fds, Gs^Fds, Gs^Fds, Gs^Fds, Ww, Ww, Ww^Es, Ww, Cv^Fet, Gg^Ve, Gs, Kv, Gs, Gg^Ve, Cv^Fet, Ww, Ww, Ww, Gs^Fds, Gs^Fms, Gs^Fds, Rp, Rp, Gd^Fds, Gs^Fds, Gs^Fds, Gs^Fds, Gs^Fds, Gs^Gvs, Gs^Fms, Gs^Fds, Gs^Fds, Gs^Fms, Gs^Fms, Gs^Fms, Gs^Fds, Gs^Fds, Gg^Ve, Gs^Fds, Gs^Fds, Gs^Fms, Gs^Fms, Gs^Fds
Gs^Fds, Gs^Fds, Gs^Fms, Kv, Cv, Gg^Em, Gg, Gs^Fms, Gs^Fds, Hh^Fds, Hh^Fds, Mm, Mm, Mm, Hh^Fds, Hh, Gs^Fdw, Gs^Fds, Rp, Gs^Fds, Gs^Fds, Gs^Fds, Gs^Fds, Gs^Fds, Ww, Ww, Cv, Cv, Gg^Efm, Gs^Efm, Wwt^Ewf, Gs^Efm, Gg^Efm, Cv, Cv, Ww, Ww, Gs^Fds, Ww, Gs^Fds, Rp, Gd^Fds, Gs^Fds, Gs^Fds, Ww^Es, Gs^Fds, Ww, Gs^Fds, Ww, Gs^Fds, Gs^Fds, Gs^Fds, Gs^Fds, Gs^Fds, Gg, Gs^Fds, Gg^Efm, Gs^Fds, Gg, Gs^Fms, Gs^Fms, Gs^Fms
Gs^Fds, Gs^Fds, Gs^Fds, Gs^Fds, Gs^Fds, Gs^Fds, Gs^Fds, Gg, Gs^Fms, Gs^Fds, Hh^Fds, Hh, Hh, Hh^Fms, Hh^Fds, Hh, Gs^Fms, Gs^Fms, Rp, Gg^Ve, Gg^Gvs, Gs^Fds, Gs^Fds, Ww, Ww, Ww, Cv, Gg^Emf, Kv, Gs^Efm, Gs^Efm, Gs^Efm, Kv, Gg^Emf, Cv, Ww, Ww, Ww, Wo^Es, Ww, Wwr, Ww, Wo, Wwr, Wo, Ww, Wo, Wwr, Wo^Es, Ww, Wo, Gs^Fds, Gs^Fds, Gs^Fds, Gs^Fds, Gg, Gg, Gg, Gs^Fds, Gs^Fds, Gs^Fds, Gs^Fms
Gs^Fds, Gs^Fds, Gg^Efm, Gg^Efm, Gg, Gs^Fds, Gg, Gg^Efm, Re, Gs^Fds, Gg, Hh, Gs^Fms, Gs^Fms, Gs^Fds, Gs^Fds, Gs^Fds, Gs^Fms, Gs^Fds, Rp, Rp, Gd^Fds, Gg^Fet, Gs^Fds, Ww, Ww, Cv^Fet, Cv, Ww, Cv, Gs, Cv, Ww, Cv, Cv^Fet, Ww, Ww, Ww, Wo, Wo^Es, Wwr, Wo, Ww, Wwr, Wwr, Wo, Wo, Wwr, Ww, Wo^Es, Wo^Es, Wo^Es, Wo, Ww, Ww, Ww, Ww, Gs^Fds, Ww, Gs^Fds, Ww, Gs^Fds
Gg, Gs^Fds, Gg, Gs^Fds, Gs^Fds, Rd^Ve, Gs^Fds, Gs^Fds, Gs^Fms, Re, Gs^Fds, Gg^Efm, Gs^Fms, Gs^Fds, Gg^Fet, Gs^Fds, Gs^Fds, Gg^Ve, Gg, Gs^Fds, Rp, Gs^Fms, Gs^Fds, Gs^Fds, Wwf, Ww, Ww, Ww, Cv, Cv, Gs, Cv, Cv, Ww, Ww, Ww, Ww, Gs^Fds, Gs^Fds, Ww, Gs, Wwr, Gs^Fds, Ww^Es, Gs, Ww^Es, Gs^Fds, Wwr, Gs^Fds, Wo, Ww, Wo, Wo, Wo^Es, Wo, Wo, Wo, Wo, Wo, Wo, Wo, Wo
Gs^Fds, Gg^Em, Gs^Fds, Gs^Fds, Gs^Fds, Ds, Ds, Gs^Fds, Gs^Fms, Gs^Fms, Gs^Fds, Re, Gg^Ve, Gg^Em, Gs^Fms, Gs^Fds, Gs^Fds, Gs^Fds, Gs^Fds, Rp, Gs^Fds, Gs^Fms, Gs^Fds, Wwf, Gs^Fds, Ww, Ww, Ww, Cv^Fet, Cv, Rp, Cv, Cv^Fet, Ww, Ww, Gs^Fds, Gs^Fds, Gs^Fds, Gs^Fds, Gs^Fds, Gs^Ve, Gs, Gs^Fds, Gs^Fds, Gs^Fms, Gs^Fds, Gs^Fds, Gs, Gs^Fds, Gs^Fds, Gs^Fds, Ww, Gs^Fds, Wo, Ww, Wo, Wo, Wo, Wo, Wo, Wo, Wo
Gs^Fds, Gs^Fds, Gg^Fet, Gs^Fds, Gs^Fds, Ds, Gs^Fds, Gs^Fds, Ds, Gs^Fds, Gs^Fds, Gs^Fds, Gg, Gs^Fds, Gs^Fds, Gs^Fds, Wwf, Gs^Fms, Gs^Fms, Rp, Rp^Ve, Gs^Fds, Gs^Fms, Wwf, Gs^Fds, Gs^Fds, Ww, Ww, Ww, Ww, Ww^Bsb|, Ww, Ww, Ww, Ww, Gs^Fds, Gs^Fds, Gs^Fms, Gs^Fms, Gs^Fds, Gs^Fds, Rp, Gs^Fds, Gs^Fds, Gs^Fms, Gs^Fds, Gs, Gs, Gs^Fms, Gs^Fds, Gs^Fds, Gs^Fds, Gs^Fds, Gs^Fds, Gs^Fds, Gs^Fds, Gs^Fds, Ww, Gs^Fds, Ww, Ww, Wo
Gs^Fds, Gs^Fds, Gs^Fds, Gs^Fds, Ds, Ds, Ww, Wwf, Wwf, Ds, Wwf, Gs^Fds, Wwf, Wwf, Wwf, Wwf, Gs^Fds, Wwf, Wwf, Gs^Fds, Gs^Fds, Rp, Wwf, Wwf, Gs^Fds, Gs^Fds, Gs^Fds, Ww, Ww, Ww, Ww^Bsb|, Ww, Ww, Ww, Gs^Fds, Wwf, Wwf, Gs^Fds, Gs^Fds, Gs^Fms, Gs^Fds, Rp, Rp, Gs^Vhs, Gs^Fds, Gs^Fms, Gs, Gs^Fms, Gs^Fds, Gs^Fds, Gs^Fms, Gs^Fds, Gs^Fds, Gs^Fds, Gs^Fds, Gs^Fms, Gs^Fms, Gs^Fds, Gs^Fds, Gs^Fds, Gs^Fds, Ww
Gs^Fds, Gs^Fds, Gs^Fds, Gs^Fds, Ds, Wwf, Ww, Gs^Fds, Gs^Fds, Wwf, Gs^Fds, Wwf, Gg, Gs^Fds, Gs^Fds, Gs^Fds, Gs^Fms, Gs^Fds, Wwf, Gs^Fds, Wwf, Wwf^Bw|, Wwf, Gs^Fds, Gg, Gs^Fds, Gs^Fds, Gs^Fds, Gs^Fds, Cv^Fet, Rrc, Cv^Fet, Gs^Fds, Gs^Fds, Gs^Fms, Ds, Ds, Wwf, Gs^Fds, Gs^Fms, Gs^Fds, Gs^Fds, Rp, Gs^Fds, Re, Gs, Gs^Fms, Gs^Fms, Gs^Fp, Gs^Fms, Gs^Fms, Ss, Gs^Fms, Gs^Fms, Gs^Fms, Gs^Fms, Gs^Fms, Gs^Fds, Gs^Fms, Gs^Fms, Gs^Fds, Gs^Fms
Gs^Fds, Gs^Fds, Gs^Fds, Ds, Wwf, Ww, Gs^Fds, Wwf, Wwf, Gs^Fds, Gs^Fms, Gg^Efm, Gg^Ve, Gs^Fds, Gs^Fms, Gs^Fds, Gs^Fms, Gs^Fds, Gs^Fds, Wwf, Gs^Fds, Rp, Gg, Gg^Efm, Gs^Fds, Gs^Ve, Gg, Gs^Fds, Gs^Fds, Gs^Fds, Rrc, Gs^Fds, Gs^Fds, Gs^Fms, Gs^Fms, Gs^Fms, Gs^Fds, Wwf^Es, Wwf^Es, Gs^Fds, Gs^Fds, Gs^Fds, Rp, Rp, Re^Ve, Re, Re, Gs^Fms, Gs^Fms, Ss, Gs^Fms, Ss, Ss, Gs^Fms, Gs^Fms, Gg^Ve, Gs^Fms, Gs^Fms, Gs^Fds, Gs^Fds, Gs^Fms, Gs^Fms
Gs^Fds, Gs^Fds, Gs^Fds, Wwf, Ds, Ds, Gs^Fds, Gs^Fds, Ww, Gs^Fds, Gs^Fds, Re, Re, Gs^Fds, Re, Re, Re, Gs^Fds, Gs^Fms, Gs^Fds, Gs^Fms, Gs^Fds, Gg^Ve, Gs^Fds, Gg^Fet, Gs^Fds, Gg^Efm, Gs^Fds, Gs^Fds, Gs^Fds, Rrc, Gs^Fds, Gs^Fds, Gs^Fms, Gs^Fds, Gs^Fms, Gs^Fds, Gs^Fms, Gs^Fds, Wwf, Rp, Rp, Gs^Fds, Gs^Fms, Gs^Fms, Gs^Fms, Gs^Fms, Gs, Ss, Ss, Ss, Gs, Gs, Ss, Ss, Gs^Em, Gll^Fp, Gs^Fds, Gs^Fds, Gll^Fp, Gs^Fms, Gs^Fds
Gs^Fds, Gs^Fds, Ww, Wwf, Ds, Gs^Fds, Wwf, Gs^Fms, Gs^Fds, Wwr, Gs^Fds, Gs^Fds, Gs^Fds, Gg, Gs^Fds, Gs^Fds, Gs^Fms, Hh^Fms, Hh, Gs^Fms, Gs^Fdw, Gs^Fds, Gg, Gs^Fds, Gs^Fds, Gs^Fds, Gg, Gs^Fds, Gs^Fds, Gs^Fds, Gs^Fds, Rrc, Rrc, Gs^Fds, Rp, Gs^Vhs, Rp, Gs^Fms, Gs^Fds, Wwf, Rp, Gs^Fds, Gll^Fds, Gs^Fms, Gll^Fds, Ss, Ss, Ss^Bw|, Gs^Fms, Gll^Fms, Gs^Fds, Ss, Gs, Ss, Wo, Ss, Ss, Gs^Fds, Gll^Fp, Gll^Fp, Gll^Fp, Gs^Fms
Wwf, Wwf, Ww, Wwf, Wwf, Wwf, Gs^Fds, Ww, Gs^Fds, Gs^Fds, Gs^Fms, Gs^Fms, Gs^Fms, Gg^Efm, Gs^Fds, Gs^Fds, Gs^Fms, Hh^Fms, Mm, Hh, Hh, Gs^Fds, Gs^Fms, Gg^Efm, Gg, Gg^Ve, Gg, Gs^Fds, Gs^Fds, Gs^Fds, Gs^Fds, Gs^Fds, Rrc, Rp, Gs^Fds, Rp, Gs^Fds, Rp, Rp, Wwf^Bw/, Gll^Fms, Gs^Fms, Gll^Fds, Gs^Fms, Gll^Fds, Ss, Gll^Fds, Re, Gs^Fds, Gs^Fds, Gs^Fms, Gs^Fms, Gs^Fds, Gs, Ss, Wo, Ss, Ss, Ss, Gll^Fp, Gs, Gll^Fp
Ww, Ww, Gs^Fds, Gs^Fds, Gs^Fms, Gs^Fds, Wwr, Ww, Wwf, Gs^Fds, Gs^Fms, Gs^Fds, Gg, Gg^Efm, Gg^Efm, Gs^Fms, Gs^Fdw, Gs^Fds, Hh, Mm, Mm, Hh, Hh, Gs^Fms, Gd^Fms, Gs^Fds, Gs^Fds, Rp, Gs^Fds, Gs^Fds, Rp, Rp, Rrc, Gs^Fds, Gs^Fds, Gs^Fms, Gs^Fds, Gs^Fds, Gs^Fds, Wwf, Wwr, Gll^Fds, Gll^Fms, Gll^Fds, Ss, Ss, Gs^Fms, Re, Re, Gs^Fds, Gs^Fds, Gs^Fms, Gs^Fms, Gll^Fp, Ss, Ss, Ss^Vhs, Gs, Ss, Ss, Gs, Gs
Wwf, Ww, Ww, Gs^Fds, Gs^Fds, Gg, Gs^Fds, Wwf, Gs^Fds, Gs^Fds, Ds, Gs^Fds, Gs^Fds, Gg^Ve, Rp, Gs^Fds, Gs^Fms, Hh, Hh, Hh, Hh, Hh, Hh, Gs^Fdw, Gs^Fms, Gs^Fds, Gs^Fds, Rp, Rp, Gs^Fds, Rp, Gs^Fds, Rrc, Gs^Fds, Gs^Fms, Gg^Fet, Gs^Fds, Gs^Fds, Gs^Fms, Gs^Fds, Ds, Ww, Ww, Ss, Gll^Fds, Gs^Fms, Gs^Fms, Gs^Fms, Re, Gs^Fms, Gs^Fms, Gs^Fms, Gll^Fp, Gll^Fp, Gll^Fp, Ss, Gs^Tf, Gs^Em, Ss, Ss, Gs, Gs
Gs^Fds, Gs^Fds, Ds, Ww, Ww, Gs^Fds, Gg^Fet, Wwf, Wwf, Gs^Fds, Ww, Ds, Gs^Fds, Gs^Fds, Rp, Gs^Fds, Gs^Fds, Gs^Fms, Gs^Fds, Wwrg, Gs^Fms, Hh, Hh, Hh, Hh^Fds, Gs^Fms, Gs^Fms, Gs^Fds, Gs^Fds, Rp, Gs^Fds, Gs^Fds, Gs^Fds, Rrc, Gs^Fds, Gs^Fds, Gs^Fms, Gs^Fds, Gs^Fms, Gs^Fms, Ds, Ww, Ww, Ds, Gs^Fms, Gs^Fms, Re, Re^Em, Gs^Fds, Gs^Fds, Gs^Fds, Gll^Fp, Gs^Fms, Gll^Fp, Gll^Fp, Gs^Em, Gs^Em, Ss, Ds, Ss, Ss, Ss
Gs^Fds, Gs^Fds, Gg^Ve, Ds, Wwf, Gs^Fds, Gg, Gg^Efm, Gg, Ww, Gs^Fds, Wwf, Wwf, Gs^Fds, Wwf, Rp, Rp, Gg, Wwf, Wwf, Gs^Fds, Gs^Fms, Hh, Hh, Gs^Fms, Gs^Fms, Gs^Fds, Gs^Fds, Gs^Fds, Gs^Fds, Gs^Fds, Gs^Fds, Gs^Fms, Rrc, Gs^Fds, Gs^Fds, Gs^Gvs, Gg^Ve, Gs^Gvs, Gs^Fms, Gs^Fms, Gs^Fms, Gs^Fds, Wwr, Gs^Fms, Gs^Fms, Gs^Vhs, Gs^Fms, Gs^Fms, Gs^Fds, Gll^Fp, Gs^Fms, Gs^Fms, Gs^Fds, Ss, Ss, Ss, Gs, Wo^Ewf, Wo^Ewl, Ds, Ss
Gs^Fds, Gs^Fds, Gs^Fds, Wwr, Wwf, Wwf, Wwf, Gs^Fds, Gs^Fds, Gs^Fms, Gs^Fds, Wwf, Gs^Fds, Wwf, Ds, Wwrg, Wwf, Wwf^Bw\, Rp, Gs^Fds, Gg^Ve, Gs^Fms, Gs^Fms, Gs^Fms, Gs^Fms, Gs^Fds, Gg^Fet, Gs^Fds, Gs^Fds, Gs^Fds, Gs^Fms, Gs^Vhs, Gs^Fds, Rrc, Gs, Gs^Fds, Re, Re, Re, Gs^Fds, Gs^Fds, Gll^Fds, Gs^Fds, Wwf, Gs^Fms, Gs^Fms, Gs^Em, Gs^Fms, Gs^Fms, Ss^Em, Ss, Ss, Ss, Ss, Ss, Ss, Gs, Ss, Wo^Ewl, Ss, Gs, Ds
Gs^Fds, Gs^Fms, Gs^Fds, Gs^Fds, Wwf, Gs^Fds, Ds, Wwf, Ww, Gs^Fds, Ww, Ww, Gs^Fds, Gs^Fds, Gs^Fds, Gs^Fds, Gs^Fds, Gs^Fds, Gs^Fds, Rp, Rp, Gs^Fds, Gs^Fds, Gs^Fms, Gs^Fds, Gs^Fds, Gs^Fds, Gs^Fds, Gs^Fds, Gs^Fms, Gs^Fms, Gs^Fms, Rrc, Rrc, Gg^Ve, Gs, Gs^Fms, Gs^Fds, Gs^Fms, Re, Re, Gs^Fms, Gs^Fds, Wwf, Re, Re, Gs^Fds, Gs^Fms, Gs^Fms, Ss, Gll^Fp, Ss, Ss, Ss, Ds, Gll^Fp, Ss, Gs, Ss, Ss, Ss, Gs
Wwf, Wwf, Wwf, Wwf, Gs^Fms, Gs^Fds, Gs^Fds, Ds, Wwf, Gs^Fds, Wwrg, Gs^Fds, Gs^Gvs, Gs^Ve, Re, Gs^Fds, Gs^Fms, Gs^Fds, Gs^Fds, Gs^Fds, Rp, Gs^Fds, Gs^Fds, Gs^Fds, Rp, Gs^Fds, Rp, Gs^Fds, Rp, Gs^Fds, Rp, Rrc, Gs^Fms, Gs^Fms, Gs^Fds, Gs^Gvs, Hh, Gs^Fms, Gs^Fds, Gs^Fms, Re, Gs^Fds, Re, Wwf^Bw/, Wwf, Gs^Fds, Gs^Fms, Gs^Fms, Gll^Fp, Gll^Fp, Gs^Fms, Ss, Ss, Ss, Ds, Gll^Fp, Ss, Ww^Vm, Ss, Ss, Gs^Tf, Gll^Fp
Gs^Fds, Gs^Fds, Gs^Fds, Gs^Fds, Gs^Fms, Gs^Fms, Gs^Fms, Gs^Fds, Rp, Wwf, Wwf, Gs^Fds, Rp, Re, Gs^Ve, Rp, Rp, Gs^Fms, Rp, Rp, Gs^Fds, Re, Re, Rp, Gs^Fds, Rp, Gs^Fds, Rp, Gg^Ve, Rp, Gs^Fds, Rrc, Gs^Fms, Gs^Fms, Gs^Fms, Gs^Fds, Hh^Fds, Hh^Fds, Hh^Fms, Gs^Fms, Gs^Fds, Re^Em, Gg^Vhs, Gs^Fms, Ds, Wwr, Ww, Ss, Ss, Ss, Ds, Gll^Fp, Gll^Em, Gll^Tf, Gll^Tf, Gll^Em, Ss, Ss, Ss, Gll^Em, Ds, Gll^Fp
Gs^Fds, Gs^Fds, Gs^Fds, Gs^Fds, Gs^Fds, Gs^Fds, Gg, Rp, Gs^Fds, Rp, Rp, Wwf^Bw/, Gs^Fds, Gs^Fds, Gs^Fds, Gs^Gvs, Gs^Fds, Rp, Gs^Fds, Gs^Fds, Gs^Fms, Gs^Fds, Gg^Em, Gs^Fds, Gs^Fms, Gs^Fds, Gs^Fms, Gs^Fds, Gs^Fds, Gs^Fds, Rrc, Rrc, Gs^Fms, Gs^Fms, Gs^Fms, Hh^Fds, Hh, Mm, Mm, Gs^Fds, Gs^Fds, Gs^Fds, Gs^Fds, Gs^Fms, Gs^Fms, Ds, Gs, Ww, Ww, Ww, Wo^Ewl, Ds, Gll, Ss, Gll, Ss, Ss, Ss, Ss, Gll, Ss, Ds
Gs^Fds, Gs^Fds, Gs^Fds, Gs^Fds, Gs^Fds, Gg^Efm, Gg^Ve, Gs^Fds, Gs^Fds, Gg, Gs^Fds, Wwf, Gs^Fds, Gs^Fds, Gg^Fet, Gs^Fds, Gs^Fds, Rp, Gs^Fds, Gs^Fds, Gs^Fds, Gs^Fms, Gs^Fds, Gs^Fds, Hh, Hh, Hh^Fdw, Gs^Fds, Gs^Fms, Gs^Fms, Rrc, Gs^Fms, Gs^Fms, Gs^Fms, Gs^Fms, Gs^Fds, Gs^Fds, Hh, Mm, Mm, Hh, Gs^Fds, Gs^Fds, Gs^Fms, Gs^Fms, Gs^Em, Gs^Tf, Ss, Ds, Ss, Wo^Ewl, Wo^Ewl, Ss, Ss, Gll, Ds, Ds, Ss, Ss, Ss, Ss, Ss
Hh^Fds, Hh^Fds, Gs^Fds, Gs^Fds, Gg^Efm, Gg^Efm, Gs^Fds, Gs^Fds, Gs^Fms, Gs^Fds, Ds, Wwf, Ww, Gs^Fds, Gs^Fds, Gs^Fds, Gg, Rp, Gg, Gs^Fds, Gs^Fds, Gs^Fds, Gs^Fds, Gs^Fds, Hh^Fds, Hh^Fds, Hh, Hh^Fms, Hh^Fms, Gs^Fds, Rrc, Gs^Fds, Re, Re, Re, Gs^Fds, Gs, Hh^Fds, Hh^Fds, Hh^Fds, Hh^Fds, Gs^Fms, Ss, Ss, Ss, Ds, Gs^Tf, Gs^Tf, Gll^Em, Ds, Ss, Ss, Ss, Ss, Ss, Gll, Wo^Ewl, Wo^Ewl, Ss, Ss, Ss, Ss
Hh^Fds, Gs^Fds, Gs^Fds, Re, Gs^Fds, Gs^Fds, Gs^Fds, Gs^Fms, Gs^Fds, Gs^Fds, Wwf, Wwf, Ds, Ww, Gs^Fds, Gs^Fds, Gs^Fds, Gs^Fds, Gs^Fds, Gg^Efm, Gs^Fms, Gs^Fds, Gs^Fms, Hh, Hh^Fds, Hh^Fds, Gs^Fms, Hh^Fms, Gs^Fms, Gs^Fds, Rrc, Re, Gs^Fms, Gs^Fds, Gs^Fms, Gs, Re, Gs^Fds, Gs^Fds, Hh^Fds, Gs^Fds, Gs^Fms, Ss, Gll, Ss, Ds, Ds, Ds, Ss, Ds, Ss, Ss, Gll, Ss, Ss, Ss, Ss, Wo^Ewf, Ss, Ss, Ds, Ss
Gs^Fds, Gs^Fds, Re, Re, Gg, Gg^Em, Gs^Fms, Gs^Fdw, Wwrg, Gs^Fds, Wwf, Ds, Gs^Fms, Ww, Wwf, Gs^Fds, Gs^Fds, Gs^Fms, Gg^Ve, Gg^Efm, Gs^Fds, Gs^Fds, Hh^Fds, Hh^Fds, Gs^Fds, Gg^Fet, Gs^Fds, Gs^Fms, Gs^Fds, Gs^Fds, Rrc, Gs^Fds, Gs^Fms, Gs^Fms, Gs^Fms, Gs^Fds, Gs^Fds, Re, Gs^Fds, Hh^Fds, Gs^Fds, Gs^Fds, Gs^Fms, Gll, Gll, Ss, Ss, Ss, Ss, Ss, Gll^Em, Gll^Tf, Gll^Tf, Ss, Ss, Ss, Ss, Ss, Ss, Gll^Fp, Ds, Gll^Fp
Gg, Gg, Hh, Hh^Fds, Gg^Em, Gs^Fds, Gs^Fds, Gs^Fds, Ww, Wwf, Gs^Fds, Gs^Fds, Gs^Fms, Gs^Fds, Gs^Fds, Wwf, Wwf^Bw/, Re, Re, Re, Gs^Fms, Gs^Fms, Gs^Fds, Gs^Fds, Gs^Fms, Gs^Fds, Gs^Fds, Gs^Fds, Rrc, Rrc, Gs^Fds, Gs^Fds, Gs^Fds, Gs^Fds, Hh^Fds, Gs^Fds, Gs^Fds, Re, Re, Gs^Vhs, Gs, Gs^Fms, Gll^Fms, Gll^Fp, Ss, Ss, Ss, Ww^Vm, Ss, Ss, Gll, Gll^Tf, Gll^Em, Gll, Ss, Ds, Gll, Gll, Gll^Fp, Gll^Fp, Gll^Fp, Gll^Fp
Hh^Fds, Hh^Fds, Hh, Gs^Fds, Hh^Fds, Gs^Fds, Wwf^Es, Ww, Ds, Ds, Gs^Fds, Gs^Fdw, Gs^Fds, Gs^Fds, Re, Re, Wwf, Gg^Em, Gs^Fds, Gs^Fms, Hh^Fds, Gs^Fds, Gs^Fms, Gs^Fds, Gs^Fms, Gs^Fds, Gs^Fds, Gs^Ve, Rrc, Gs^Fds, Gs^Fds, Gs^Fds, Gs^Fds, Gs^Fds, Mm, Hh, Gs^Fds, Gs^Fds, Gll^Fp, Re, Gll^Fp, Gs, Re, Gs^Fetd, Ds, Ss, Ss, Ss, Ss, Gll, Ds, Ds, Ss, Ds, Ss, Ds, Ds, Gll, Ss, Ss, Ss, Gll^Fp
Hh^Fds, Hh^Fds, Hh^Fdw, Hh, Hh^Fms, Hh^Fds, Wwf^Es, Wwf^Es, Ds, Ds, Ds, Gs^Fds, Gg^Efm, Gg^Efm, Gs^Fds, Gs^Fds, Gs^Fds, Wwf, Gs^Fds, Gs^Fds, Hh, Gs^Fds, Gs^Fds, Gs^Fds, Gs^Fds, Gs^Fds, Gs^Fds, Gs^Fds, Rrc, Gs^Fds, Gs^Fds, Gs^Fds, Gs^Fds, Gs^Fds, Hh, Hh, Hh^Fds, Gs^Fms, Gs^Fms, Gll^Fp, Gs^Tf, Re, Ds, Re, Re, Gll^Em, Ss, Ss, Wo^Ewf, Gll, Ss, Ds, Ss, Ss, Ss, Ss, Ss, Ss, Ss, Ss, Ss, Ss
Hh^Fds, Hh^Fds, Hh^Fds, Hh^Fds, Hh^Fms, Wwrg, Wwf^Es, Wwf, Gs^Fds, Gs^Fds, Gs^Gvs, Gg^Ve, Gg, Gs^Fds, Gg, Gs^Fds, Gs^Fds, Wwf, Wwf, Hh^Fds, Hh, Gs^Fds, Hh^Fds, Hh^Fds, Hh^Fms, Hh^Fdw, Gs^Fms, Gs^Fms, Rrc, Gs^Fds, Gs^Fds, Gs^Fds, Mm, Hh^Fds, Mm, Mm, Hh^Ve, Hh^Fds, Hh^Fds, Gll^Fp, Gs^Em, Gs, Ss, Ds, Ss, Gs^Tf, Gll, Ss, Wo^Ewl, Ss, Ss, Ds, Ss, Ss, Ss, Ss, Gll^Em, Gll, Ss, Ss, Ss, Ss
Hh^Fms, Hh^Fms, Hh^Fds, Hh^Fds, Hh^Fds, Hh, Ww, Ww, Gs^Fds, Gs^Fds, Gs^Fds, Gs^Gvs, Gg, Gs^Fds, Gg^Efm, Gs^Fds, Gs^Fds, Gs^Fds, Gs^Fds, Hh, Hh^Fds, Hh^Fds, Hh^Fds, Hh, Hh^Fds, Hh^Fms, Gs^Fds, Gs^Fds, Rrc, Gs^Fds, Gs^Fds, Gs^Fds, Hh^Fds, Hh^Fds, Mm, Mm, Hh, Hh, Hh^Fds, Hh^Fds, Gs^Fms, Ss, Gll^Fp, Ss, Ss, Ss, Gll, Wo^Ewl, Wo^Ewl, Ss, Ss, Ss, Ss, Ww^Vm, Ss, Ss, Ds, Gll^Tf, Gll^Tf, Ss, Ss, Ss
Hh^Fds, Hh^Fms, Hh^Fds, Ds, Ds, Wwf, Wwf, Ds, Ds, Gg^Em, Gs^Fds, Gg, Gs^Fds, Gg, Gs^Fds, Gg^Em, Gs^Fds, Gs^Fds, Hh^Fds, Hh^Fds, Hh^Fds, Hh^Fds, Hh, Hh^Fms, Hh, Gs^Fds, Gs^Fds, Rrc, Gs^Fds, Gs^Fds, Gs^Fds, Gs^Fds, Hh^Fds, Hh^Fds, Hh, Mm, Hh, Hh, Hh^Fds, Hh, Hh^Fds, Gs^Fms, Gs^Fms, Gll^Fp, Ss, Gll, Ds, Ds, Ss, Ss, Gll^Fp, Gll^Fp, Ss, Ss, Wo^Ewl, Ss, Ds, Gll^Tf, Gll^Fp, Gll^Em, Ds, Ss
Hh^Fds, Hh^Fds, Gs^Fds, Ds, Ww, Ww, Wwf, Wwrg, Ds, Ds, Gs^Fds, Gg, Gs^Fds, Gs^Fds, Gs^Fds, Gs^Fds, Gs^Fds, Hh^Fds, Hh^Fds, Hh^Fds, Hh^Fds, Hh, Gs^Fds, Hh^Fms, Hh^Fds, Hh^Fds, Gs^Fds, Rrc, Gs^Fds, Gs^Fds, Gs^Fds, Gs^Fds, Gs^Fds, Hh, Mm, Mm, Mm, Mm, Mm, Hh^Fds, Hh^Fds, Hh^Fds, Gs, Gll^Fp, Ss, Ss, Ss, Ss, Ss, Gll^Fp, Gll^Fp, Gll^Fp, Gll^Fp, Ss, Wo^Ewl, Wo^Ewl, Ss, Ds, Gll^Fp, Gll^Fp, Ds, Ds
